AAAAATCAACGGGACCGGC: AAAATCAACGGGACCGGCG
AAAACACCCCAGAGCACAC: AAACACCCCAGAGCACACT
AAAACATTTCGCTAGATGT: AAACATTTCGCTAGATGTA
AAAAGCGAGATGTCTGCAA: AAAGCGAGATGTCTGCAAC
AAAATATCTCTCCTTCGAT: AAATATCTCTCCTTCGATT
AAAATCAACGGGACCGGCG: AAATCAACGGGACCGGCGG
AAACACATCCCGTCGAGAA: AACACATCCCGTCGAGAAG
AAACACCCCAGAGCACACT: AACACCCCAGAGCACACTG
AAACAGGCCTAACGTCTTG: AACAGGCCTAACGTCTTGA
AAACATTTCGCTAGATGTA: AACATTTCGCTAGATGTAT
AAAGCAGGGTTATAAACAC: AAGCAGGGTTATAAACACA
AAAGCGAGATGTCTGCAAC: AAGCGAGATGTCTGCAACA
AAAGGATCTTAACATGATC: AAGGATCTTAACATGATCT
AAATACCGCGTCTCGTCCT: AATACCGCGTCTCGTCCTC
AAATATCTCTCCTTCGATT: AATATCTCTCCTTCGATTG
AAATATTGCGAATTGTTTA: AATATTGCGAATTGTTTAA
AAATCAACGGGACCGGCGG: AATCAACGGGACCGGCGGG
AAATCCTTGTTTGAGGCAT: AATCCTTGTTTGAGGCATG
AAATGGCTATCCCCTGCCA: AATGGCTATCCCCTGCCAC
AAATTAATGCCTGAGTCGG: AATTAATGCCTGAGTCGGA
AAATTGCAAGGCTTGCTCT: AATTGCAAGGCTTGCTCTA
AACAACGGCAAGTCGTCGA: ACAACGGCAAGTCGTCGAG
AACACATACTACGTCGGAT: ACACATACTACGTCGGATC
AACACATCCCGTCGAGAAG: ACACATCCCGTCGAGAAGA
AACACCCCAGAGCACACTG: ACACCCCAGAGCACACTGT
AACACGTTGTCGGTTGCTG: ACACGTTGTCGGTTGCTGG
AACAGCATCAAGGCATAAT: ACAGCATCAAGGCATAATT
AACAGCATCACTATGCGCG: ACAGCATCACTATGCGCGC
AACAGCATCAGCGTAATGC: ACAGCATCAGCGTAATGCG
AACAGCATCATAATGGAAG: ACAGCATCATAATGGAAGG
AACAGGCCTAACGTCTTGA: ACAGGCCTAACGTCTTGAA
AACAGGTATTTGACAATAG: ACAGGTATTTGACAATAGG
AACATAATGGACATGGTTC: ACATAATGGACATGGTTCT
AACATGATCTCATGAGTGG: ACATGATCTCATGAGTGGA
AACATTCTACTGTATATCT: ACATTCTACTGTATATCTC
AACATTTCGCTAGATGTAT: ACATTTCGCTAGATGTATC
AACCATGACCACATCAATA: ACCATGACCACATCAATAG
AACCCACCGGCTACCGCTA: ACCCACCGGCTACCGCTAT
AACCCCCATATCAGGTCTA: ACCCCCATATCAGGTCTAA
AACCGGCGGTGCCGTCAGC: ACCGGCGGTGCCGTCAGCA
AACCGTCGGGGGAGCTCTT: ACCGTCGGGGGAGCTCTTA
AACCTTCTTAGGCTACCCG: ACCTTCTTAGGCTACCCGT
AACCTTTGATTCTAGTCCT: ACCTTTGATTCTAGTCCTC
AACGCAAGTACAACTCGAG: ACGCAAGTACAACTCGAGT
AACGGCAAATTAATGCCTG: ACGGCAAATTAATGCCTGA
AACGGCAAGTCGTCGAGGG: ACGGCAAGTCGTCGAGGGC
AACGGGACCGGCGGGTATA: ACGGGACCGGCGGGTATAG
AACGTCTTGAAGGACGTAA: ACGTCTTGAAGGACGTAAT
AACGTGCAAGTGCCGTGCT: ACGTGCAAGTGCCGTGCTT
AACGTGGCTCTATCTAGAA: ACGTGGCTCTATCTAGAAC
AACTAACGGCAAATTAATG: ACTAACGGCAAATTAATGC
AACTACTCCCCTCTCAGGG: ACTACTCCCCTCTCAGGGT
AACTAGCGCAACTACTCCC: ACTAGCGCAACTACTCCCC
AACTCATTTCCGTGGCTGC: ACTCATTTCCGTGGCTGCG
AACTCGAGTTGTAAAGGAT: ACTCGAGTTGTAAAGGATC
AACTCGCCATACTTGGGGC: ACTCGCCATACTTGGGGCC
AACTGAATCGTCGAATCGC: ACTGAATCGTCGAATCGCA
AAGAAATTGCAAGGCTTGC: AGAAATTGCAAGGCTTGCT
AAGAAGGTTTAAGGGCCAG: AGAAGGTTTAAGGGCCAGG
AAGAATGCTAACCGGCGGT: AGAATGCTAACCGGCGGTG
AAGACATCGTACAACAGCA: AGACATCGTACAACAGCAT
AAGATCCTGTGGCTAGGAA: AGATCCTGTGGCTAGGAAA
AAGCAGATATACCTTCTCA: AGCAGATATACCTTCTCAC
AAGCAGGGTTATAAACACA: AGCAGGGTTATAAACACAT
AAGCAGGTACTGTGTGTAG: AGCAGGTACTGTGTGTAGC
AAGCGAGATGTCTGCAACA: AGCGAGATGTCTGCAACAC
AAGCGGGAGTGACCGTGGC: AGCGGGAGTGACCGTGGCA
AAGCGTTGACGAACACATA: AGCGTTGACGAACACATAC
AAGCTATTACTAATCAACT: AGCTATTACTAATCAACTC
AAGGAACGTGGCTCTATCT: AGGAACGTGGCTCTATCTA
AAGGACGTAATAGGAATGA: AGGACGTAATAGGAATGAT
AAGGATCAGACTTCTCGTG: AGGATCAGACTTCTCGTGC
AAGGATCTTAACATGATCT: AGGATCTTAACATGATCTC
AAGGCATAATTGTCAGACT: AGGCATAATTGTCAGACTT
AAGGCTGGGTTGCCTATGG: AGGCTGGGTTGCCTATGGC
AAGGCTTGCTCTACCCCTT: AGGCTTGCTCTACCCCTTC
AAGGGCCAGGACGTCAACG: AGGGCCAGGACGTCAACGT
AAGGTGACACCTTCTGTAT: AGGTGACACCTTCTGTATG
AAGGTTTAAGGGCCAGGAC: AGGTTTAAGGGCCAGGACG
AAGTAAAGCAGGGTTATAA: AGTAAAGCAGGGTTATAAA
AAGTACAACTCGAGTTGTA: AGTACAACTCGAGTTGTAA
AAGTCGGCAGCCCCGAAGG: AGTCGGCAGCCCCGAAGGC
AAGTCGTCGAGGGCCGTAA: AGTCGTCGAGGGCCGTAAT
AAGTGACCCTTCGTGGTGC: AGTGACCCTTCGTGGTGCC
AAGTGCCGTGCTTGAAGCA: AGTGCCGTGCTTGAAGCAG
AATACCGCGTCTCGTCCTC: ATACCGCGTCTCGTCCTCT
AATACGGTCACTTATCTTC: ATACGGTCACTTATCTTCG
AATACTTCCATCCTCTTCT: ATACTTCCATCCTCTTCTG
AATAGCGCAGTGAACTGAA: ATAGCGCAGTGAACTGAAT
AATAGGAATGATCGGTGAT: ATAGGAATGATCGGTGATG
AATAGGTAGACAATACGGT: ATAGGTAGACAATACGGTC
AATAGGTTGCTTACAGGAC: ATAGGTTGCTTACAGGACA
AATATCTCTCCTTCGATTG: ATATCTCTCCTTCGATTGG
AATATTGCGAATTGTTTAA: ATATTGCGAATTGTTTAAT
AATCAACGGGACCGGCGGG: ATCAACGGGACCGGCGGGT
AATCAACTCATTTCCGTGG: ATCAACTCATTTCCGTGGC
AATCACTGAAGCTATTACT: ATCACTGAAGCTATTACTA
AATCATGCCTGGACGCCAA: ATCATGCCTGGACGCCAAC
AATCCAGTCATTGGGTGCC: ATCCAGTCATTGGGTGCCT
AATCCCTAGATGAGTTATG: ATCCCTAGATGAGTTATGA
AATCCTGCCTGAGTCAGCG: ATCCTGCCTGAGTCAGCGT
AATCCTTGTTTGAGGCATG: ATCCTTGTTTGAGGCATGA
AATCGCAGGTGCTGTCGGG: ATCGCAGGTGCTGTCGGGC
AATCGTCGAATCGCAGGTG: ATCGTCGAATCGCAGGTGC
AATGAGTTTGAAGAAGGTT: ATGAGTTTGAAGAAGGTTT
AATGATCGGTGATGGAGTA: ATGATCGGTGATGGAGTAG
AATGCCTGAGTCGGATCAC: ATGCCTGAGTCGGATCACT
AATGCGTTCAGACTTCTCG: ATGCGTTCAGACTTCTCGT
AATGCTAACCGGCGGTGCC: ATGCTAACCGGCGGTGCCG
AATGGAAGGATCAGACTTC: ATGGAAGGATCAGACTTCT
AATGGACATGGTTCTCGAC: ATGGACATGGTTCTCGACC
AATGGCTATCCCCTGCCAC: ATGGCTATCCCCTGCCACC
AATGTAGCCGAATAGGTAG: ATGTAGCCGAATAGGTAGA
AATGTTCTCTCAGAACAAC: ATGTTCTCTCAGAACAACG
AATTAATGCCTGAGTCGGA: ATTAATGCCTGAGTCGGAT
AATTAGCAATCACTGAAGC: ATTAGCAATCACTGAAGCT
AATTCCAGTCCGTGTTTGA: ATTCCAGTCCGTGTTTGAC
AATTCCCGACACAAGATCC: ATTCCCGACACAAGATCCT
AATTGCAAGGCTTGCTCTA: ATTGCAAGGCTTGCTCTAC
AATTGTCAGACTTCTCGTG: ATTGTCAGACTTCTCGTGC
AATTGTTTAATCCCTAGAT: ATTGTTTAATCCCTAGATG
AATTTTAGGGTTTACGGGC: ATTTTAGGGTTTACGGGCG
ACAACAGCATCAAGGCATA: CAACAGCATCAAGGCATAA
ACAACAGCATCACTATGCG: CAACAGCATCACTATGCGC
ACAACAGCATCAGCGTAAT: CAACAGCATCAGCGTAATG
ACAACAGCATCATAATGGA: CAACAGCATCATAATGGAA
ACAACGGCAAGTCGTCGAG: CAACGGCAAGTCGTCGAGG
ACAACTCGAGTTGTAAAGG: CAACTCGAGTTGTAAAGGA
ACAAGATCCTGTGGCTAGG: CAAGATCCTGTGGCTAGGA
ACAATACGGTCACTTATCT: CAATACGGTCACTTATCTT
ACAATAGGTTGCTTACAGG: CAATAGGTTGCTTACAGGA
ACACAAGATCCTGTGGCTA: CACAAGATCCTGTGGCTAG
ACACAGAGATGGCTAACCT: CACAGAGATGGCTAACCTT
ACACATACTACGTCGGATC: CACATACTACGTCGGATCG
ACACATCCCGTCGAGAAGA: CACATCCCGTCGAGAAGAA
ACACCCCAGAGCACACTGT: CACCCCAGAGCACACTGTA
ACACCTTCTGTATGGCTCA: CACCTTCTGTATGGCTCAA
ACACGTTGTCGGTTGCTGG: CACGTTGTCGGTTGCTGGA
ACACTGTATCATCCCCCAG: CACTGTATCATCCCCCAGC
ACAGAATGAGTTTGAAGAA: CAGAATGAGTTTGAAGAAG
ACAGAGAGCAGCCAGTAGT: CAGAGAGCAGCCAGTAGTG
ACAGAGATGGCTAACCTTT: CAGAGATGGCTAACCTTTG
ACAGCATACTATAGACGAA: CAGCATACTATAGACGAAT
ACAGCATCAAGGCATAATT: CAGCATCAAGGCATAATTG
ACAGCATCACTATGCGCGC: CAGCATCACTATGCGCGCC
ACAGCATCAGCGTAATGCG: CAGCATCAGCGTAATGCGT
ACAGCATCATAATGGAAGG: CAGCATCATAATGGAAGGA
ACAGGACATAGTATTGTTA: CAGGACATAGTATTGTTAG
ACAGGCCTAACGTCTTGAA: CAGGCCTAACGTCTTGAAG
ACAGGTATTTGACAATAGG: CAGGTATTTGACAATAGGT
ACAGTAAATCCTTGTTTGA: CAGTAAATCCTTGTTTGAG
ACAGTACCTAGCTACAGAA: CAGTACCTAGCTACAGAAT
ACATAATGGACATGGTTCT: CATAATGGACATGGTTCTC
ACATACTACGTCGGATCGA: CATACTACGTCGGATCGAT
ACATAGTATTGTTAGCAAA: CATAGTATTGTTAGCAAAC
ACATATGCGGCGTCATCAG: CATATGCGGCGTCATCAGG
ACATATTTTTAATTCCAGT: CATATTTTTAATTCCAGTC
ACATCAATAGCGCAGTGAA: CATCAATAGCGCAGTGAAC
ACATCCCGTCGAGAAGAAA: CATCCCGTCGAGAAGAAAT
ACATCGTACAACAGCATCA: CATCGTACAACAGCATCAA
ACATGATCTCATGAGTGGA: CATGATCTCATGAGTGGAT
ACATGGTTCTCGACCATCG: CATGGTTCTCGACCATCGT
ACATGTATTAGACCTATGT: CATGTATTAGACCTATGTA
ACATTAAGACATCGTACAA: CATTAAGACATCGTACAAC
ACATTCACGTTCCTAGTCA: CATTCACGTTCCTAGTCAA
ACATTCAGCGTCGCGGCTC: CATTCAGCGTCGCGGCTCC
ACATTCTACTGTATATCTC: CATTCTACTGTATATCTCT
ACATTTCGCTAGATGTATC: CATTTCGCTAGATGTATCT
ACCAAGAATGCTAACCGGC: CCAAGAATGCTAACCGGCG
ACCACATCAATAGCGCAGT: CCACATCAATAGCGCAGTG
ACCACTAGCCCCTAACAGG: CCACTAGCCCCTAACAGGT
ACCAGTGATCGTTGCTCTC: CCAGTGATCGTTGCTCTCG
ACCATCGTACAACAGCATC: CCATCGTACAACAGCATCA
ACCATGACCACATCAATAG: CCATGACCACATCAATAGC
ACCCACCGGCTACCGCTAT: CCCACCGGCTACCGCTATA
ACCCAGCAGGATCCGACCG: CCCAGCAGGATCCGACCGT
ACCCATTTTCCTCCGGAAC: CCCATTTTCCTCCGGAACT
ACCCCAGAGCACACTGTAT: CCCCAGAGCACACTGTATC
ACCCCCATATCAGGTCTAA: CCCCCATATCAGGTCTAAA
ACCCCTTCTCAATTAGCAA: CCCCTTCTCAATTAGCAAT
ACCCGACATTAAGACATCG: CCCGACATTAAGACATCGT
ACCCGTATCAAGTGACCCT: CCCGTATCAAGTGACCCTT
ACCCTTCGTGGTGCCATTT: CCCTTCGTGGTGCCATTTC
ACCGCGTCTCGTCCTCTTC: CCGCGTCTCGTCCTCTTCT
ACCGCTATACTAAGCGTTG: CCGCTATACTAAGCGTTGA
ACCGGCGGGTATAGGGAGA: CCGGCGGGTATAGGGAGAC
ACCGGCGGTGCCGTCAGCA: CCGGCGGTGCCGTCAGCAT
ACCGGCTACCGCTATACTA: CCGGCTACCGCTATACTAA
ACCGTCGGGGGAGCTCTTA: CCGTCGGGGGAGCTCTTAA
ACCGTCGTCTAGACGAGTA: CCGTCGTCTAGACGAGTAC
ACCGTGGCATCCTTGCGCA: CCGTGGCATCCTTGCGCAC
ACCGTTGATCTCACGACCC: CCGTTGATCTCACGACCCA
ACCTAGCTACAGAATGAGT: CCTAGCTACAGAATGAGTT
ACCTATGTAAAAGCGAGAT: CCTATGTAAAAGCGAGATG
ACCTCCGCTCAGAACGCAA: CCTCCGCTCAGAACGCAAG
ACCTGAGCCTTGGGCGATG: CCTGAGCCTTGGGCGATGT
ACCTTCTCACCAAGAATGC: CCTTCTCACCAAGAATGCT
ACCTTCTGTATGGCTCAAG: CCTTCTGTATGGCTCAAGT
ACCTTCTTAGGCTACCCGT: CCTTCTTAGGCTACCCGTA
ACCTTTGATTCTAGTCCTC: CCTTTGATTCTAGTCCTCA
ACGAACACATACTACGTCG: CGAACACATACTACGTCGG
ACGAATTCCCGACACAAGA: CGAATTCCCGACACAAGAT
ACGACCCATTTTCCTCCGG: CGACCCATTTTCCTCCGGA
ACGAGTACCACTAGCCCCT: CGAGTACCACTAGCCCCTA
ACGCAAGTACAACTCGAGT: CGCAAGTACAACTCGAGTT
ACGCAGTGTACCTGAGCCT: CGCAGTGTACCTGAGCCTT
ACGCCAACCATGACCACAT: CGCCAACCATGACCACATC
ACGGCAAATTAATGCCTGA: CGGCAAATTAATGCCTGAG
ACGGCAAGTCGTCGAGGGC: CGGCAAGTCGTCGAGGGCC
ACGGGACCGGCGGGTATAG: CGGGACCGGCGGGTATAGG
ACGGGCGAATCCTGCCTGA: CGGGCGAATCCTGCCTGAG
ACGGTCACTTATCTTCGTT: CGGTCACTTATCTTCGTTC
ACGGTTCGTGGAGCGCGAT: CGGTTCGTGGAGCGCGATG
ACGTAATAGGAATGATCGG: CGTAATAGGAATGATCGGT
ACGTCAACGTGCAAGTGCC: CGTCAACGTGCAAGTGCCG
ACGTCGGATCGATGACTGA: CGTCGGATCGATGACTGAT
ACGTCTTGAAGGACGTAAT: CGTCTTGAAGGACGTAATA
ACGTGCAAGTGCCGTGCTT: CGTGCAAGTGCCGTGCTTG
ACGTGCCCCCAACATTCTA: CGTGCCCCCAACATTCTAC
ACGTGGCTCTATCTAGAAC: CGTGGCTCTATCTAGAACC
ACGTGTTTTCAAGTCGGCA: CGTGTTTTCAAGTCGGCAG
ACGTTCCTAGTCAACATAA: CGTTCCTAGTCAACATAAT
ACGTTGTCGGTTGCTGGAA: CGTTGTCGGTTGCTGGAAT
ACTAACGGCAAATTAATGC: CTAACGGCAAATTAATGCC
ACTAAGCGTTGACGAACAC: CTAAGCGTTGACGAACACA
ACTAATCAACTCATTTCCG: CTAATCAACTCATTTCCGT
ACTACGTCGGATCGATGAC: CTACGTCGGATCGATGACT
ACTACTCCCCTCTCAGGGT: CTACTCCCCTCTCAGGGTA
ACTAGCCCCTAACAGGTAT: CTAGCCCCTAACAGGTATT
ACTAGCGCAACTACTCCCC: CTAGCGCAACTACTCCCCT
ACTATAGACGAATTCCCGA: CTATAGACGAATTCCCGAC
ACTATGCGCGCCTCAGACT: CTATGCGCGCCTCAGACTT
ACTATTACATATGCGGCGT: CTATTACATATGCGGCGTC
ACTCATTTCCGTGGCTGCG: CTCATTTCCGTGGCTGCGA
ACTCCACAGTACCTAGCTA: CTCCACAGTACCTAGCTAC
ACTCCCCTCTCAGGGTAGA: CTCCCCTCTCAGGGTAGAC
ACTCGAGTTGTAAAGGATC: CTCGAGTTGTAAAGGATCT
ACTCGCCATACTTGGGGCC: CTCGCCATACTTGGGGCCG
ACTCTGCTTTTCGTGACTG: CTCTGCTTTTCGTGACTGT
ACTGAAGCTATTACTAATC: CTGAAGCTATTACTAATCA
ACTGAATCGTCGAATCGCA: CTGAATCGTCGAATCGCAG
ACTGACTATTACATATGCG: CTGACTATTACATATGCGG
ACTGATATCTCCGAAGGTG: CTGATATCTCCGAAGGTGA
ACTGTAGTATTCTCTCTTC: CTGTAGTATTCTCTCTTCA
ACTGTATATCTCTCAAAAT: CTGTATATCTCTCAAAATA
ACTGTATCATCCCCCAGCT: CTGTATCATCCCCCAGCTA
ACTGTGTGTAGCTCGCTTC: CTGTGTGTAGCTCGCTTCC
ACTTAGACCCAGCAGGATC: CTTAGACCCAGCAGGATCC
ACTTATCTTCGTTCAGCTA: CTTATCTTCGTTCAGCTAT
ACTTCCATCCTCTTCTGCA: CTTCCATCCTCTTCTGCAA
ACTTCTCGTGCCGACATAT: CTTCTCGTGCCGACATATT
ACTTCTCGTGCCGACTGAC: CTTCTCGTGCCGACTGACT
ACTTCTCGTGCCGACTTGA: CTTCTCGTGCCGACTTGAA
ACTTCTCGTGCCGACTTTT: CTTCTCGTGCCGACTTTTG
ACTTGAAGGAACGTGGCTC: CTTGAAGGAACGTGGCTCT
ACTTGGGGCCGGCCGAGGA: CTTGGGGCCGGCCGAGGAT
ACTTTTGCATGATTAGGCT: CTTTTGCATGATTAGGCTT
AGAAATTGCAAGGCTTGCT: GAAATTGCAAGGCTTGCTC
AGAACAACGGCAAGTCGTC: GAACAACGGCAAGTCGTCG
AGAACCCACCGGCTACCGC: GAACCCACCGGCTACCGCT
AGAACGCAAGTACAACTCG: GAACGCAAGTACAACTCGA
AGAAGAAATTGCAAGGCTT: GAAGAAATTGCAAGGCTTG
AGAAGGTTTAAGGGCCAGG: GAAGGTTTAAGGGCCAGGA
AGAATGAGTTTGAAGAAGG: GAATGAGTTTGAAGAAGGT
AGAATGCTAACCGGCGGTG: GAATGCTAACCGGCGGTGC
AGACAATACGGTCACTTAT: GACAATACGGTCACTTATC
AGACATCGTACAACAGCAT: GACATCGTACAACAGCATC
AGACATGTATTAGACCTAT: GACATGTATTAGACCTATG
AGACCCAGCAGGATCCGAC: GACCCAGCAGGATCCGACC
AGACCTATGTAAAAGCGAG: GACCTATGTAAAAGCGAGA
AGACGAATTCCCGACACAA: GACGAATTCCCGACACAAG
AGACGAGTACCACTAGCCC: GACGAGTACCACTAGCCCC
AGACGGTTCGTGGAGCGCG: GACGGTTCGTGGAGCGCGA
AGACTTAGACCCAGCAGGA: GACTTAGACCCAGCAGGAT
AGACTTCTCGTGCCGACAT: GACTTCTCGTGCCGACATA
AGACTTCTCGTGCCGACTG: GACTTCTCGTGCCGACTGA
AGACTTCTCGTGCCGACTT: GACTTCTCGTGCCGACTTT GACTTCTCGTGCCGACTTG
AGAGAGCAGCCAGTAGTGC: GAGAGCAGCCAGTAGTGCC
AGAGATGGCTAACCTTTGA: GAGATGGCTAACCTTTGAT
AGAGCACACTGTATCATCC: GAGCACACTGTATCATCCC
AGAGCAGCCAGTAGTGCCA: GAGCAGCCAGTAGTGCCAG
AGATACGCAGTGTACCTGA: GATACGCAGTGTACCTGAG
AGATATACCTTCTCACCAA: GATATACCTTCTCACCAAG
AGATCCTGTGGCTAGGAAA: GATCCTGTGGCTAGGAAAT
AGATGAGTTATGATTTGTG: GATGAGTTATGATTTGTGA
AGATGGCTAACCTTTGATT: GATGGCTAACCTTTGATTC
AGATGTATCTTACGTGCCC: GATGTATCTTACGTGCCCC
AGATGTCTGCAACACGTTG: GATGTCTGCAACACGTTGT
AGCAAACAGGCCTAACGTC: GCAAACAGGCCTAACGTCT
AGCAATCACTGAAGCTATT: GCAATCACTGAAGCTATTA
AGCACACTGTATCATCCCC: GCACACTGTATCATCCCCC
AGCAGATATACCTTCTCAC: GCAGATATACCTTCTCACC
AGCAGCCAGTAGTGCCAGG: GCAGCCAGTAGTGCCAGGT
AGCAGGATCCGACCGTTGA: GCAGGATCCGACCGTTGAT
AGCAGGGTTATAAACACAT: GCAGGGTTATAAACACATC
AGCAGGTACTGTGTGTAGC: GCAGGTACTGTGTGTAGCT
AGCATACTATAGACGAATT: GCATACTATAGACGAATTC
AGCATCAAGGCATAATTGT: GCATCAAGGCATAATTGTC
AGCATCACTATGCGCGCCT: GCATCACTATGCGCGCCTC
AGCATCAGCGTAATGCGTT: GCATCAGCGTAATGCGTTC
AGCATCATAATGGAAGGAT: GCATCATAATGGAAGGATC
AGCATGCCGGGCCCCGGGC: GCATGCCGGGCCCCGGGCA
AGCCAGTAGTGCCAGGTCG: GCCAGTAGTGCCAGGTCGT
AGCCCCGAAGGCTGGGTTG: GCCCCGAAGGCTGGGTTGC
AGCCCCTAACAGGTATTTG: GCCCCTAACAGGTATTTGA
AGCCGAATAGGTAGACAAT: GCCGAATAGGTAGACAATA
AGCCTTGGGCGATGTGGTG: GCCTTGGGCGATGTGGTGG
AGCGAGATGTCTGCAACAC: GCGAGATGTCTGCAACACG
AGCGCAACTACTCCCCTCT: GCGCAACTACTCCCCTCTC
AGCGCAGTGAACTGAATCG: GCGCAGTGAACTGAATCGT
AGCGCGATGGGGCATCGTA: GCGCGATGGGGCATCGTAC
AGCGGGAGTGACCGTGGCA: GCGGGAGTGACCGTGGCAT
AGCGTAATGCGTTCAGACT: GCGTAATGCGTTCAGACTT
AGCGTCAAGCGGGAGTGAC: GCGTCAAGCGGGAGTGACC
AGCGTCGCGGCTCCTTATG: GCGTCGCGGCTCCTTATGG
AGCGTGTTGAGGGGGCCCC: GCGTGTTGAGGGGGCCCCA
AGCGTTGACGAACACATAC: GCGTTGACGAACACATACT
AGCTACAGAATGAGTTTGA: GCTACAGAATGAGTTTGAA
AGCTACCCGACATTAAGAC: GCTACCCGACATTAAGACA
AGCTATGGCGTAATTTTAG: GCTATGGCGTAATTTTAGG
AGCTATTACTAATCAACTC: GCTATTACTAATCAACTCA
AGCTATTCACCTCCGCTCA: GCTATTCACCTCCGCTCAG
AGCTCGCTTCCGTCCTGCG: GCTCGCTTCCGTCCTGCGT
AGCTCTTAAAACACCCCAG: GCTCTTAAAACACCCCAGA
AGCTTTATCCCGCCGCATT: GCTTTATCCCGCCGCATTC
AGGAAATACCGCGTCTCGT: GGAAATACCGCGTCTCGTC
AGGAACGTGGCTCTATCTA: GGAACGTGGCTCTATCTAG
AGGAATGATCGGTGATGGA: GGAATGATCGGTGATGGAG
AGGACAGTAAATCCTTGTT: GGACAGTAAATCCTTGTTT
AGGACATAGTATTGTTAGC: GGACATAGTATTGTTAGCA
AGGACGTAATAGGAATGAT: GGACGTAATAGGAATGATC
AGGACGTCAACGTGCAAGT: GGACGTCAACGTGCAAGTG
AGGATCAGACTTCTCGTGC: GGATCAGACTTCTCGTGCC
AGGATCCGACCGTTGATCT: GGATCCGACCGTTGATCTC
AGGATCTTAACATGATCTC: GGATCTTAACATGATCTCA
AGGATTGTGCGAGCGTGTT: GGATTGTGCGAGCGTGTTG
AGGCATAATTGTCAGACTT: GGCATAATTGTCAGACTTC
AGGCATGATCCGAACCTTC: GGCATGATCCGAACCTTCT
AGGCCTAACGTCTTGAAGG: GGCCTAACGTCTTGAAGGA
AGGCTACCCGTATCAAGTG: GGCTACCCGTATCAAGTGA
AGGCTGGGTTGCCTATGGC: GGCTGGGTTGCCTATGGCG
AGGCTTGACACAGAGATGG: GGCTTGACACAGAGATGGC
AGGCTTGCTCTACCCCTTC: GGCTTGCTCTACCCCTTCT
AGGGAGACTTAGACCCAGC: GGGAGACTTAGACCCAGCA
AGGGCCAGGACGTCAACGT: GGGCCAGGACGTCAACGTG
AGGGCCGTAATCATGCCTG: GGGCCGTAATCATGCCTGG
AGGGGGCCCCAATCCAGTC: GGGGGCCCCAATCCAGTCA
AGGGTAGACATGTATTAGA: GGGTAGACATGTATTAGAC
AGGGTTATAAACACATCCC: GGGTTATAAACACATCCCG
AGGGTTTACGGGCGAATCC: GGGTTTACGGGCGAATCCT
AGGTACTGTGTGTAGCTCG: GGTACTGTGTGTAGCTCGC
AGGTAGACAATACGGTCAC: GGTAGACAATACGGTCACT
AGGTATTTGACAATAGGTT: GGTATTTGACAATAGGTTG
AGGTCGTAAGCAGATATAC: GGTCGTAAGCAGATATACC
AGGTCTAAAACATTTCGCT: GGTCTAAAACATTTCGCTA
AGGTGACACCTTCTGTATG: GGTGACACCTTCTGTATGG
AGGTGCTGTCGGGCGCAAA: GGTGCTGTCGGGCGCAAAT
AGGTTGCTTACAGGACATA: GGTTGCTTACAGGACATAG
AGGTTTAAGGGCCAGGACG: GGTTTAAGGGCCAGGACGT
AGTAAAGCAGGGTTATAAA: GTAAAGCAGGGTTATAAAC
AGTAAATCCTTGTTTGAGG: GTAAATCCTTGTTTGAGGC
AGTACAACTCGAGTTGTAA: GTACAACTCGAGTTGTAAA
AGTACCACTAGCCCCTAAC: GTACCACTAGCCCCTAACA
AGTACCTAGCTACAGAATG: GTACCTAGCTACAGAATGA
AGTAGATACGCAGTGTACC: GTAGATACGCAGTGTACCT
AGTAGTAGATACGCAGTGT: GTAGTAGATACGCAGTGTA
AGTAGTGCCAGGTCGTAAG: GTAGTGCCAGGTCGTAAGC
AGTATTCTCTCTTCATCGT: GTATTCTCTCTTCATCGTA
AGTATTGTTAGCAAACAGG: GTATTGTTAGCAAACAGGC
AGTCAACATAATGGACATG: GTCAACATAATGGACATGG
AGTCAGCGTCAAGCGGGAG: GTCAGCGTCAAGCGGGAGT
AGTCATTGGGTGCCTTGCA: GTCATTGGGTGCCTTGCAG
AGTCCGTGTTTGACATTCA: GTCCGTGTTTGACATTCAC
AGTCCTCAGCTTTATCCCG: GTCCTCAGCTTTATCCCGC
AGTCGGATCACTCCACAGT: GTCGGATCACTCCACAGTA
AGTCGGCAGCCCCGAAGGC: GTCGGCAGCCCCGAAGGCT
AGTCGTCGAGGGCCGTAAT: GTCGTCGAGGGCCGTAATC
AGTGAACTGAATCGTCGAA: GTGAACTGAATCGTCGAAT
AGTGACCCTTCGTGGTGCC: GTGACCCTTCGTGGTGCCA
AGTGACCGTGGCATCCTTG: GTGACCGTGGCATCCTTGC
AGTGATCGTTGCTCTCGCC: GTGATCGTTGCTCTCGCCC
AGTGCCAGGTCGTAAGCAG: GTGCCAGGTCGTAAGCAGA
AGTGCCGTGCTTGAAGCAG: GTGCCGTGCTTGAAGCAGG
AGTGGATATGGCTGGCCAC: GTGGATATGGCTGGCCACA
AGTGTACCTGAGCCTTGGG: GTGTACCTGAGCCTTGGGC
AGTGTGCGCAAAAATCAAC: GTGTGCGCAAAAATCAACG
AGTTATGATTTGTGACTCT: GTTATGATTTGTGACTCTG
AGTTGTAAAGGATCTTAAC: GTTGTAAAGGATCTTAACA
AGTTTGAAGAAGGTTTAAG: GTTTGAAGAAGGTTTAAGG
ATAAACACATCCCGTCGAG: TAAACACATCCCGTCGAGA
ATAACCCCCATATCAGGTC: TAACCCCCATATCAGGTCT
ATAATGGAAGGATCAGACT: TAATGGAAGGATCAGACTT
ATAATGGACATGGTTCTCG: TAATGGACATGGTTCTCGA
ATAATTGTCAGACTTCTCG: TAATTGTCAGACTTCTCGT
ATACCGCGTCTCGTCCTCT: TACCGCGTCTCGTCCTCTT
ATACCTTCTCACCAAGAAT: TACCTTCTCACCAAGAATG
ATACGCAGTGTACCTGAGC: TACGCAGTGTACCTGAGCC
ATACGGTCACTTATCTTCG: TACGGTCACTTATCTTCGT
ATACTAAGCGTTGACGAAC: TACTAAGCGTTGACGAACA
ATACTACGTCGGATCGATG: TACTACGTCGGATCGATGA
ATACTATAGACGAATTCCC: TACTATAGACGAATTCCCG
ATACTTCCATCCTCTTCTG: TACTTCCATCCTCTTCTGC
ATACTTGGGGCCGGCCGAG: TACTTGGGGCCGGCCGAGG
ATAGACGAATTCCCGACAC: TAGACGAATTCCCGACACA
ATAGCGCAGTGAACTGAAT: TAGCGCAGTGAACTGAATC
ATAGGAATGATCGGTGATG: TAGGAATGATCGGTGATGG
ATAGGGAGACTTAGACCCA: TAGGGAGACTTAGACCCAG
ATAGGTAGACAATACGGTC: TAGGTAGACAATACGGTCA
ATAGGTTGCTTACAGGACA: TAGGTTGCTTACAGGACAT
ATAGTATTGTTAGCAAACA: TAGTATTGTTAGCAAACAG
ATATACCTTCTCACCAAGA: TATACCTTCTCACCAAGAA
ATATCAGGTCTAAAACATT: TATCAGGTCTAAAACATTT
ATATCTCCGAAGGTGACAC: TATCTCCGAAGGTGACACC
ATATCTCTCAAAATATCTC: TATCTCTCAAAATATCTCT
ATATCTCTCCTTCGATTGG: TATCTCTCCTTCGATTGGG
ATATGCGGCGTCATCAGGA: TATGCGGCGTCATCAGGAC
ATATGGCTGGCCACATTCA: TATGGCTGGCCACATTCAG
ATATTGCGAATTGTTTAAT: TATTGCGAATTGTTTAATC
ATATTTTTAATTCCAGTCC: TATTTTTAATTCCAGTCCG
ATCAACGGGACCGGCGGGT: TCAACGGGACCGGCGGGTA
ATCAACTCATTTCCGTGGC: TCAACTCATTTCCGTGGCT
ATCAAGGCATAATTGTCAG: TCAAGGCATAATTGTCAGA
ATCAAGTGACCCTTCGTGG: TCAAGTGACCCTTCGTGGT
ATCAATAGCGCAGTGAACT: TCAATAGCGCAGTGAACTG
ATCACTATGCGCGCCTCAG: TCACTATGCGCGCCTCAGA
ATCACTCCACAGTACCTAG: TCACTCCACAGTACCTAGC
ATCACTGAAGCTATTACTA: TCACTGAAGCTATTACTAA
ATCAGACTTCTCGTGCCGA: TCAGACTTCTCGTGCCGAC
ATCAGCGTAATGCGTTCAG: TCAGCGTAATGCGTTCAGA
ATCAGGACAGTAAATCCTT: TCAGGACAGTAAATCCTTG
ATCAGGTCTAAAACATTTC: TCAGGTCTAAAACATTTCG
ATCATAATGGAAGGATCAG: TCATAATGGAAGGATCAGA
ATCATCCCCCAGCTATGGC: TCATCCCCCAGCTATGGCG
ATCATGCCTGGACGCCAAC: TCATGCCTGGACGCCAACC
ATCCAGTCATTGGGTGCCT: TCCAGTCATTGGGTGCCTT
ATCCCCCAGCTATGGCGTA: TCCCCCAGCTATGGCGTAA
ATCCCCTGCCACCAGTGAT: TCCCCTGCCACCAGTGATC
ATCCCGCCGCATTCGCGGC: TCCCGCCGCATTCGCGGCC
ATCCCGTCGAGAAGAAATT: TCCCGTCGAGAAGAAATTG
ATCCCTAGATGAGTTATGA: TCCCTAGATGAGTTATGAT
ATCCGAACCTTCTTAGGCT: TCCGAACCTTCTTAGGCTA
ATCCGACCGTTGATCTCAC: TCCGACCGTTGATCTCACG
ATCCTACCGTCGTCTAGAC: TCCTACCGTCGTCTAGACG
ATCCTCTTCTGCAACTAGC: TCCTCTTCTGCAACTAGCG
ATCCTGCCTGAGTCAGCGT: TCCTGCCTGAGTCAGCGTC
ATCCTGTGGCTAGGAAATA: TCCTGTGGCTAGGAAATAC
ATCCTTGTTTGAGGCATGA: TCCTTGTTTGAGGCATGAT
ATCGATGACTGATATCTCC: TCGATGACTGATATCTCCG
ATCGCAGGTGCTGTCGGGC: TCGCAGGTGCTGTCGGGCG
ATCGGTGATGGAGTAGTAG: TCGGTGATGGAGTAGTAGA
ATCGTACAACAGCATCAAG: TCGTACAACAGCATCAAGG
ATCGTACAACAGCATCACT: TCGTACAACAGCATCACTA
ATCGTACAACAGCATCAGC: TCGTACAACAGCATCAGCG
ATCGTACAACAGCATCATA: TCGTACAACAGCATCATAA
ATCGTCGAATCGCAGGTGC: TCGTCGAATCGCAGGTGCT
ATCGTTGCTCTCGCCCTAT: TCGTTGCTCTCGCCCTATA
ATCTAGAACCCACCGGCTA: TCTAGAACCCACCGGCTAC
ATCTCACGACCCATTTTCC: TCTCACGACCCATTTTCCT
ATCTCATGAGTGGATATGG: TCTCATGAGTGGATATGGC
ATCTCCGAAGGTGACACCT: TCTCCGAAGGTGACACCTT
ATCTCTCAAAATATCTCTC: TCTCTCAAAATATCTCTCC
ATCTCTCCTTCGATTGGGC: TCTCTCCTTCGATTGGGCG
ATCTTAACATGATCTCATG: TCTTAACATGATCTCATGA
ATCTTACGTGCCCCCAACA: TCTTACGTGCCCCCAACAT
ATCTTCGTTCAGCTATTCA: TCTTCGTTCAGCTATTCAC
ATGACCACATCAATAGCGC: TGACCACATCAATAGCGCA
ATGACTGATATCTCCGAAG: TGACTGATATCTCCGAAGG
ATGAGACGGTTCGTGGAGC: TGAGACGGTTCGTGGAGCG
ATGAGTGGATATGGCTGGC: TGAGTGGATATGGCTGGCC
ATGAGTTATGATTTGTGAC: TGAGTTATGATTTGTGACT
ATGAGTTTGAAGAAGGTTT: TGAGTTTGAAGAAGGTTTA
ATGATCCGAACCTTCTTAG: TGATCCGAACCTTCTTAGG
ATGATCGGTGATGGAGTAG: TGATCGGTGATGGAGTAGT
ATGATCTCATGAGTGGATA: TGATCTCATGAGTGGATAT
ATGATTAGGCTTGACACAG: TGATTAGGCTTGACACAGA
ATGATTTGTGACTCTGCTT: TGATTTGTGACTCTGCTTT
ATGCACGTGTTTTCAAGTC: TGCACGTGTTTTCAAGTCG
ATGCCGGGCCCCGGGCATG: TGCCGGGCCCCGGGCATGC
ATGCCTGAGTCGGATCACT: TGCCTGAGTCGGATCACTC
ATGCCTGGACGCCAACCAT: TGCCTGGACGCCAACCATG
ATGCGCGCCTCAGACTTCT: TGCGCGCCTCAGACTTCTC
ATGCGGCGTCATCAGGACA: TGCGGCGTCATCAGGACAG
ATGCGTTCAGACTTCTCGT: TGCGTTCAGACTTCTCGTG
ATGCTAACCGGCGGTGCCG: TGCTAACCGGCGGTGCCGT
ATGGAAGGATCAGACTTCT: TGGAAGGATCAGACTTCTC
ATGGACAGCATACTATAGA: TGGACAGCATACTATAGAC
ATGGACATGGTTCTCGACC: TGGACATGGTTCTCGACCA
ATGGAGTAGTAGATACGCA: TGGAGTAGTAGATACGCAG
ATGGCGAATACTTCCATCC: TGGCGAATACTTCCATCCT
ATGGCGTAATTTTAGGGTT: TGGCGTAATTTTAGGGTTT
ATGGCTAACCTTTGATTCT: TGGCTAACCTTTGATTCTA
ATGGCTATCCCCTGCCACC: TGGCTATCCCCTGCCACCA
ATGGCTCAAGTAAAGCAGG: TGGCTCAAGTAAAGCAGGG
ATGGCTGGCCACATTCAGC: TGGCTGGCCACATTCAGCG
ATGGGGCATCGTACAACAG: TGGGGCATCGTACAACAGC
ATGGTTCTCGACCATCGTA: TGGTTCTCGACCATCGTAC
ATGTAAAAGCGAGATGTCT: TGTAAAAGCGAGATGTCTG
ATGTAGCCGAATAGGTAGA: TGTAGCCGAATAGGTAGAC
ATGTATCTTACGTGCCCCC: TGTATCTTACGTGCCCCCA
ATGTATTAGACCTATGTAA: TGTATTAGACCTATGTAAA
ATGTCTGCAACACGTTGTC: TGTCTGCAACACGTTGTCG
ATGTGGTGGCAATGTAGCC: TGTGGTGGCAATGTAGCCG
ATGTTCTCTCAGAACAACG: TGTTCTCTCAGAACAACGG
ATTAAGACATCGTACAACA: TTAAGACATCGTACAACAG
ATTAATGCCTGAGTCGGAT: TTAATGCCTGAGTCGGATC
ATTACATATGCGGCGTCAT: TTACATATGCGGCGTCATC
ATTACTAATCAACTCATTT: TTACTAATCAACTCATTTC
ATTAGACCTATGTAAAAGC: TTAGACCTATGTAAAAGCG
ATTAGCAATCACTGAAGCT: TTAGCAATCACTGAAGCTA
ATTAGGCTTGACACAGAGA: TTAGGCTTGACACAGAGAT
ATTCACCTCCGCTCAGAAC: TTCACCTCCGCTCAGAACG
ATTCACGTTCCTAGTCAAC: TTCACGTTCCTAGTCAACA
ATTCAGCGTCGCGGCTCCT: TTCAGCGTCGCGGCTCCTT
ATTCCAGTCCGTGTTTGAC: TTCCAGTCCGTGTTTGACA
ATTCCCGACACAAGATCCT: TTCCCGACACAAGATCCTG
ATTCGCGGCCGTACAGAGA: TTCGCGGCCGTACAGAGAG
ATTCTACTGTATATCTCTC: TTCTACTGTATATCTCTCA
ATTCTAGTCCTCAGCTTTA: TTCTAGTCCTCAGCTTTAT
ATTCTCTCTTCATCGTACA: TTCTCTCTTCATCGTACAA
ATTGAACCGTCGGGGGAGC: TTGAACCGTCGGGGGAGCT
ATTGCAAGGCTTGCTCTAC: TTGCAAGGCTTGCTCTACC
ATTGCGAATTGTTTAATCC: TTGCGAATTGTTTAATCCC
ATTGGGCGGCTCTCAGCTA: TTGGGCGGCTCTCAGCTAC
ATTGGGTGCCTTGCAGTGT: TTGGGTGCCTTGCAGTGTG
ATTGTCAGACTTCTCGTGC: TTGTCAGACTTCTCGTGCC
ATTGTGCGAGCGTGTTGAG: TTGTGCGAGCGTGTTGAGG
ATTGTTAGCAAACAGGCCT: TTGTTAGCAAACAGGCCTA
ATTGTTTAATCCCTAGATG: TTGTTTAATCCCTAGATGA
ATTTCCGTGGCTGCGAACT: TTTCCGTGGCTGCGAACTC
ATTTCGATCCTACCGTCGT: TTTCGATCCTACCGTCGTC
ATTTCGCTAGATGTATCTT: TTTCGCTAGATGTATCTTA
ATTTGACAATAGGTTGCTT: TTTGACAATAGGTTGCTTA
ATTTGTGACTCTGCTTTTC: TTTGTGACTCTGCTTTTCG
ATTTTAGGGTTTACGGGCG: TTTTAGGGTTTACGGGCGA
ATTTTCCTCCGGAACTAAC: TTTTCCTCCGGAACTAACG
ATTTTTAATTCCAGTCCGT: TTTTTAATTCCAGTCCGTG
CAAAAATCAACGGGACCGG: AAAAATCAACGGGACCGGC
CAAAATATCTCTCCTTCGA: AAAATATCTCTCCTTCGAT
CAAACAGGCCTAACGTCTT: AAACAGGCCTAACGTCTTG
CAAATATTGCGAATTGTTT: AAATATTGCGAATTGTTTA
CAAATGGCTATCCCCTGCC: AAATGGCTATCCCCTGCCA
CAAATTAATGCCTGAGTCG: AAATTAATGCCTGAGTCGG
CAACACGTTGTCGGTTGCT: AACACGTTGTCGGTTGCTG
CAACAGCATCAAGGCATAA: AACAGCATCAAGGCATAAT
CAACAGCATCACTATGCGC: AACAGCATCACTATGCGCG
CAACAGCATCAGCGTAATG: AACAGCATCAGCGTAATGC
CAACAGCATCATAATGGAA: AACAGCATCATAATGGAAG
CAACATAATGGACATGGTT: AACATAATGGACATGGTTC
CAACATTCTACTGTATATC: AACATTCTACTGTATATCT
CAACCATGACCACATCAAT: AACCATGACCACATCAATA
CAACGGCAAGTCGTCGAGG: AACGGCAAGTCGTCGAGGG
CAACGGGACCGGCGGGTAT: AACGGGACCGGCGGGTATA
CAACGTGCAAGTGCCGTGC: AACGTGCAAGTGCCGTGCT
CAACTACTCCCCTCTCAGG: AACTACTCCCCTCTCAGGG
CAACTAGCGCAACTACTCC: AACTAGCGCAACTACTCCC
CAACTCATTTCCGTGGCTG: AACTCATTTCCGTGGCTGC
CAACTCGAGTTGTAAAGGA: AACTCGAGTTGTAAAGGAT
CAAGAATGCTAACCGGCGG: AAGAATGCTAACCGGCGGT
CAAGATCCTGTGGCTAGGA: AAGATCCTGTGGCTAGGAA
CAAGCGGGAGTGACCGTGG: AAGCGGGAGTGACCGTGGC
CAAGGCATAATTGTCAGAC: AAGGCATAATTGTCAGACT
CAAGGCTTGCTCTACCCCT: AAGGCTTGCTCTACCCCTT
CAAGTAAAGCAGGGTTATA: AAGTAAAGCAGGGTTATAA
CAAGTACAACTCGAGTTGT: AAGTACAACTCGAGTTGTA
CAAGTCGGCAGCCCCGAAG: AAGTCGGCAGCCCCGAAGG
CAAGTCGTCGAGGGCCGTA: AAGTCGTCGAGGGCCGTAA
CAAGTGACCCTTCGTGGTG: AAGTGACCCTTCGTGGTGC
CAAGTGCCGTGCTTGAAGC: AAGTGCCGTGCTTGAAGCA
CAATACGGTCACTTATCTT: AATACGGTCACTTATCTTC
CAATAGCGCAGTGAACTGA: AATAGCGCAGTGAACTGAA
CAATAGGTTGCTTACAGGA: AATAGGTTGCTTACAGGAC
CAATCACTGAAGCTATTAC: AATCACTGAAGCTATTACT
CAATCCAGTCATTGGGTGC: AATCCAGTCATTGGGTGCC
CAATGTAGCCGAATAGGTA: AATGTAGCCGAATAGGTAG
CAATTAGCAATCACTGAAG: AATTAGCAATCACTGAAGC
CACAAGATCCTGTGGCTAG: ACAAGATCCTGTGGCTAGG
CACACTGTATCATCCCCCA: ACACTGTATCATCCCCCAG
CACAGAGATGGCTAACCTT: ACAGAGATGGCTAACCTTT
CACAGTACCTAGCTACAGA: ACAGTACCTAGCTACAGAA
CACATACTACGTCGGATCG: ACATACTACGTCGGATCGA
CACATCAATAGCGCAGTGA: ACATCAATAGCGCAGTGAA
CACATCCCGTCGAGAAGAA: ACATCCCGTCGAGAAGAAA
CACATTCAGCGTCGCGGCT: ACATTCAGCGTCGCGGCTC
CACCAAGAATGCTAACCGG: ACCAAGAATGCTAACCGGC
CACCAGTGATCGTTGCTCT: ACCAGTGATCGTTGCTCTC
CACCCCAGAGCACACTGTA: ACCCCAGAGCACACTGTAT
CACCGGCTACCGCTATACT: ACCGGCTACCGCTATACTA
CACCTCCGCTCAGAACGCA: ACCTCCGCTCAGAACGCAA
CACCTTCTGTATGGCTCAA: ACCTTCTGTATGGCTCAAG
CACGACCCATTTTCCTCCG: ACGACCCATTTTCCTCCGG
CACGTGTTTTCAAGTCGGC: ACGTGTTTTCAAGTCGGCA
CACGTTCCTAGTCAACATA: ACGTTCCTAGTCAACATAA
CACGTTGTCGGTTGCTGGA: ACGTTGTCGGTTGCTGGAA
CACTAGCCCCTAACAGGTA: ACTAGCCCCTAACAGGTAT
CACTATGCGCGCCTCAGAC: ACTATGCGCGCCTCAGACT
CACTCCACAGTACCTAGCT: ACTCCACAGTACCTAGCTA
CACTGAAGCTATTACTAAT: ACTGAAGCTATTACTAATC
CACTGTATCATCCCCCAGC: ACTGTATCATCCCCCAGCT
CACTTATCTTCGTTCAGCT: ACTTATCTTCGTTCAGCTA
CAGAACAACGGCAAGTCGT: AGAACAACGGCAAGTCGTC
CAGAACGCAAGTACAACTC: AGAACGCAAGTACAACTCG
CAGAATGAGTTTGAAGAAG: AGAATGAGTTTGAAGAAGG
CAGACTTCTCGTGCCGACA: AGACTTCTCGTGCCGACAT
CAGACTTCTCGTGCCGACT: AGACTTCTCGTGCCGACTT AGACTTCTCGTGCCGACTT AGACTTCTCGTGCCGACTG
CAGAGAGCAGCCAGTAGTG: AGAGAGCAGCCAGTAGTGC
CAGAGATGGCTAACCTTTG: AGAGATGGCTAACCTTTGA
CAGAGCACACTGTATCATC: AGAGCACACTGTATCATCC
CAGATATACCTTCTCACCA: AGATATACCTTCTCACCAA
CAGCAGGATCCGACCGTTG: AGCAGGATCCGACCGTTGA
CAGCATACTATAGACGAAT: AGCATACTATAGACGAATT
CAGCATCAAGGCATAATTG: AGCATCAAGGCATAATTGT
CAGCATCACTATGCGCGCC: AGCATCACTATGCGCGCCT
CAGCATCAGCGTAATGCGT: AGCATCAGCGTAATGCGTT
CAGCATCATAATGGAAGGA: AGCATCATAATGGAAGGAT
CAGCATGCCGGGCCCCGGG: AGCATGCCGGGCCCCGGGC
CAGCCAGTAGTGCCAGGTC: AGCCAGTAGTGCCAGGTCG
CAGCCCCGAAGGCTGGGTT: AGCCCCGAAGGCTGGGTTG
CAGCGTAATGCGTTCAGAC: AGCGTAATGCGTTCAGACT
CAGCGTCAAGCGGGAGTGA: AGCGTCAAGCGGGAGTGAC
CAGCGTCGCGGCTCCTTAT: AGCGTCGCGGCTCCTTATG
CAGCTACCCGACATTAAGA: AGCTACCCGACATTAAGAC
CAGCTATGGCGTAATTTTA: AGCTATGGCGTAATTTTAG
CAGCTATTCACCTCCGCTC: AGCTATTCACCTCCGCTCA
CAGCTTTATCCCGCCGCAT: AGCTTTATCCCGCCGCATT
CAGGACAGTAAATCCTTGT: AGGACAGTAAATCCTTGTT
CAGGACATAGTATTGTTAG: AGGACATAGTATTGTTAGC
CAGGACGTCAACGTGCAAG: AGGACGTCAACGTGCAAGT
CAGGATCCGACCGTTGATC: AGGATCCGACCGTTGATCT
CAGGCCTAACGTCTTGAAG: AGGCCTAACGTCTTGAAGG
CAGGGTAGACATGTATTAG: AGGGTAGACATGTATTAGA
CAGGGTTATAAACACATCC: AGGGTTATAAACACATCCC
CAGGTACTGTGTGTAGCTC: AGGTACTGTGTGTAGCTCG
CAGGTATTTGACAATAGGT: AGGTATTTGACAATAGGTT
CAGGTCGTAAGCAGATATA: AGGTCGTAAGCAGATATAC
CAGGTCTAAAACATTTCGC: AGGTCTAAAACATTTCGCT
CAGGTGCTGTCGGGCGCAA: AGGTGCTGTCGGGCGCAAA
CAGTAAATCCTTGTTTGAG: AGTAAATCCTTGTTTGAGG
CAGTACCTAGCTACAGAAT: AGTACCTAGCTACAGAATG
CAGTAGTGCCAGGTCGTAA: AGTAGTGCCAGGTCGTAAG
CAGTCATTGGGTGCCTTGC: AGTCATTGGGTGCCTTGCA
CAGTCCGTGTTTGACATTC: AGTCCGTGTTTGACATTCA
CAGTGAACTGAATCGTCGA: AGTGAACTGAATCGTCGAA
CAGTGATCGTTGCTCTCGC: AGTGATCGTTGCTCTCGCC
CAGTGTACCTGAGCCTTGG: AGTGTACCTGAGCCTTGGG
CAGTGTGCGCAAAAATCAA: AGTGTGCGCAAAAATCAAC
CATAATGGAAGGATCAGAC: ATAATGGAAGGATCAGACT
CATAATGGACATGGTTCTC: ATAATGGACATGGTTCTCG
CATAATTGTCAGACTTCTC: ATAATTGTCAGACTTCTCG
CATACTACGTCGGATCGAT: ATACTACGTCGGATCGATG
CATACTATAGACGAATTCC: ATACTATAGACGAATTCCC
CATACTTGGGGCCGGCCGA: ATACTTGGGGCCGGCCGAG
CATAGTATTGTTAGCAAAC: ATAGTATTGTTAGCAAACA
CATATCAGGTCTAAAACAT: ATATCAGGTCTAAAACATT
CATATGCGGCGTCATCAGG: ATATGCGGCGTCATCAGGA
CATATTTTTAATTCCAGTC: ATATTTTTAATTCCAGTCC
CATCAAGGCATAATTGTCA: ATCAAGGCATAATTGTCAG
CATCAATAGCGCAGTGAAC: ATCAATAGCGCAGTGAACT
CATCACTATGCGCGCCTCA: ATCACTATGCGCGCCTCAG
CATCAGCGTAATGCGTTCA: ATCAGCGTAATGCGTTCAG
CATCAGGACAGTAAATCCT: ATCAGGACAGTAAATCCTT
CATCATAATGGAAGGATCA: ATCATAATGGAAGGATCAG
CATCCCCCAGCTATGGCGT: ATCCCCCAGCTATGGCGTA
CATCCCGTCGAGAAGAAAT: ATCCCGTCGAGAAGAAATT
CATCCTCTTCTGCAACTAG: ATCCTCTTCTGCAACTAGC
CATCGTACAACAGCATCAA: ATCGTACAACAGCATCAAG
CATCGTACAACAGCATCAC: ATCGTACAACAGCATCACT
CATCGTACAACAGCATCAG: ATCGTACAACAGCATCAGC
CATCGTACAACAGCATCAT: ATCGTACAACAGCATCATA
CATGACCACATCAATAGCG: ATGACCACATCAATAGCGC
CATGAGACGGTTCGTGGAG: ATGAGACGGTTCGTGGAGC
CATGAGTGGATATGGCTGG: ATGAGTGGATATGGCTGGC
CATGATCCGAACCTTCTTA: ATGATCCGAACCTTCTTAG
CATGATCTCATGAGTGGAT: ATGATCTCATGAGTGGATA
CATGATTAGGCTTGACACA: ATGATTAGGCTTGACACAG
CATGCACGTGTTTTCAAGT: ATGCACGTGTTTTCAAGTC
CATGCCGGGCCCCGGGCAT: ATGCCGGGCCCCGGGCATG
CATGCCTGGACGCCAACCA: ATGCCTGGACGCCAACCAT
CATGGTTCTCGACCATCGT: ATGGTTCTCGACCATCGTA
CATGTATTAGACCTATGTA: ATGTATTAGACCTATGTAA
CATTAAGACATCGTACAAC: ATTAAGACATCGTACAACA
CATTCACGTTCCTAGTCAA: ATTCACGTTCCTAGTCAAC
CATTCAGCGTCGCGGCTCC: ATTCAGCGTCGCGGCTCCT
CATTCGCGGCCGTACAGAG: ATTCGCGGCCGTACAGAGA
CATTCTACTGTATATCTCT: ATTCTACTGTATATCTCTC
CATTGGGTGCCTTGCAGTG: ATTGGGTGCCTTGCAGTGT
CATTTCCGTGGCTGCGAAC: ATTTCCGTGGCTGCGAACT
CATTTCGATCCTACCGTCG: ATTTCGATCCTACCGTCGT
CATTTCGCTAGATGTATCT: ATTTCGCTAGATGTATCTT
CATTTTCCTCCGGAACTAA: ATTTTCCTCCGGAACTAAC
CCAACATTCTACTGTATAT: CAACATTCTACTGTATATC
CCAACCATGACCACATCAA: CAACCATGACCACATCAAT
CCAAGAATGCTAACCGGCG: CAAGAATGCTAACCGGCGG
CCAATCCAGTCATTGGGTG: CAATCCAGTCATTGGGTGC
CCACAGTACCTAGCTACAG: CACAGTACCTAGCTACAGA
CCACATCAATAGCGCAGTG: CACATCAATAGCGCAGTGA
CCACATTCAGCGTCGCGGC: CACATTCAGCGTCGCGGCT
CCACCAGTGATCGTTGCTC: CACCAGTGATCGTTGCTCT
CCACCGGCTACCGCTATAC: CACCGGCTACCGCTATACT
CCACTAGCCCCTAACAGGT: CACTAGCCCCTAACAGGTA
CCAGAGCACACTGTATCAT: CAGAGCACACTGTATCATC
CCAGCAGGATCCGACCGTT: CAGCAGGATCCGACCGTTG
CCAGCTATGGCGTAATTTT: CAGCTATGGCGTAATTTTA
CCAGGACGTCAACGTGCAA: CAGGACGTCAACGTGCAAG
CCAGGTCGTAAGCAGATAT: CAGGTCGTAAGCAGATATA
CCAGTAGTGCCAGGTCGTA: CAGTAGTGCCAGGTCGTAA
CCAGTCATTGGGTGCCTTG: CAGTCATTGGGTGCCTTGC
CCAGTCCGTGTTTGACATT: CAGTCCGTGTTTGACATTC
CCAGTGATCGTTGCTCTCG: CAGTGATCGTTGCTCTCGC
CCATACTTGGGGCCGGCCG: CATACTTGGGGCCGGCCGA
CCATATCAGGTCTAAAACA: CATATCAGGTCTAAAACAT
CCATCCTCTTCTGCAACTA: CATCCTCTTCTGCAACTAG
CCATCGTACAACAGCATCA: CATCGTACAACAGCATCAC
CCATGACCACATCAATAGC: CATGACCACATCAATAGCG
CCATTTCGATCCTACCGTC: CATTTCGATCCTACCGTCG
CCATTTTCCTCCGGAACTA: CATTTTCCTCCGGAACTAA
CCCAACATTCTACTGTATA: CCAACATTCTACTGTATAT
CCCAATCCAGTCATTGGGT: CCAATCCAGTCATTGGGTG
CCCACCGGCTACCGCTATA: CCACCGGCTACCGCTATAC
CCCAGAGCACACTGTATCA: CCAGAGCACACTGTATCAT
CCCAGCAGGATCCGACCGT: CCAGCAGGATCCGACCGTT
CCCAGCTATGGCGTAATTT: CCAGCTATGGCGTAATTTT
CCCATATCAGGTCTAAAAC: CCATATCAGGTCTAAAACA
CCCATTTTCCTCCGGAACT: CCATTTTCCTCCGGAACTA
CCCCAACATTCTACTGTAT: CCCAACATTCTACTGTATA
CCCCAATCCAGTCATTGGG: CCCAATCCAGTCATTGGGT
CCCCAGAGCACACTGTATC: CCCAGAGCACACTGTATCA
CCCCAGCTATGGCGTAATT: CCCAGCTATGGCGTAATTT
CCCCATATCAGGTCTAAAA: CCCATATCAGGTCTAAAAC
CCCCCAACATTCTACTGTA: CCCCAACATTCTACTGTAT
CCCCCAGCTATGGCGTAAT: CCCCAGCTATGGCGTAATT
CCCCCATATCAGGTCTAAA: CCCCATATCAGGTCTAAAA
CCCCGAAGGCTGGGTTGCC: CCCGAAGGCTGGGTTGCCT
CCCCGGGCATGCACGTGTT: CCCGGGCATGCACGTGTTT
CCCCTAACAGGTATTTGAC: CCCTAACAGGTATTTGACA
CCCCTCTCAGGGTAGACAT: CCCTCTCAGGGTAGACATG
CCCCTGCCACCAGTGATCG: CCCTGCCACCAGTGATCGT
CCCCTTCTCAATTAGCAAT: CCCTTCTCAATTAGCAATC
CCCGAAGGCTGGGTTGCCT: CCGAAGGCTGGGTTGCCTA
CCCGACACAAGATCCTGTG: CCGACACAAGATCCTGTGG
CCCGACATTAAGACATCGT: CCGACATTAAGACATCGTA
CCCGCCGCATTCGCGGCCG: CCGCCGCATTCGCGGCCGT
CCCGGGCATGCACGTGTTT: CCGGGCATGCACGTGTTTT
CCCGTATCAAGTGACCCTT: CCGTATCAAGTGACCCTTC
CCCGTCGAGAAGAAATTGC: CCGTCGAGAAGAAATTGCA
CCCTAACAGGTATTTGACA: CCTAACAGGTATTTGACAA
CCCTAGATGAGTTATGATT: CCTAGATGAGTTATGATTT
CCCTATAACCCCCATATCA: CCTATAACCCCCATATCAG
CCCTCTCAGGGTAGACATG: CCTCTCAGGGTAGACATGT
CCCTGCCACCAGTGATCGT: CCTGCCACCAGTGATCGTT
CCCTTCGTGGTGCCATTTC: CCTTCGTGGTGCCATTTCG
CCCTTCTCAATTAGCAATC: CCTTCTCAATTAGCAATCA
CCGAACCTTCTTAGGCTAC: CGAACCTTCTTAGGCTACC
CCGAAGGCTGGGTTGCCTA: CGAAGGCTGGGTTGCCTAT
CCGAAGGTGACACCTTCTG: CGAAGGTGACACCTTCTGT
CCGAATAGGTAGACAATAC: CGAATAGGTAGACAATACG
CCGACACAAGATCCTGTGG: CGACACAAGATCCTGTGGC
CCGACATATTTTTAATTCC: CGACATATTTTTAATTCCA
CCGACATTAAGACATCGTA: CGACATTAAGACATCGTAC
CCGACCGTTGATCTCACGA: CGACCGTTGATCTCACGAC
CCGACTGACTATTACATAT: CGACTGACTATTACATATG
CCGACTTGAAGGAACGTGG: CGACTTGAAGGAACGTGGC
CCGACTTTTGCATGATTAG: CGACTTTTGCATGATTAGG
CCGAGGATTGTGCGAGCGT: CGAGGATTGTGCGAGCGTG
CCGCATTCGCGGCCGTACA: CGCATTCGCGGCCGTACAG
CCGCCGCATTCGCGGCCGT: CGCCGCATTCGCGGCCGTA
CCGCGTCTCGTCCTCTTCT: CGCGTCTCGTCCTCTTCTG
CCGCTATACTAAGCGTTGA: CGCTATACTAAGCGTTGAC
CCGCTCAGAACGCAAGTAC: CGCTCAGAACGCAAGTACA
CCGGAACTAACGGCAAATT: CGGAACTAACGGCAAATTA
CCGGCCGAGGATTGTGCGA: CGGCCGAGGATTGTGCGAG
CCGGCGGGTATAGGGAGAC: CGGCGGGTATAGGGAGACT
CCGGCGGTGCCGTCAGCAT: CGGCGGTGCCGTCAGCATG
CCGGCTACCGCTATACTAA: CGGCTACCGCTATACTAAG
CCGGGCATGCACGTGTTTT: CGGGCATGCACGTGTTTTC
CCGGGCCCCGGGCATGCAC: CGGGCCCCGGGCATGCACG
CCGTAATCATGCCTGGACG: CGTAATCATGCCTGGACGC
CCGTACAGAGAGCAGCCAG: CGTACAGAGAGCAGCCAGT
CCGTATCAAGTGACCCTTC: CGTATCAAGTGACCCTTCG
CCGTCAGCATGCCGGGCCC: CGTCAGCATGCCGGGCCCC
CCGTCCTGCGTATTGAACC: CGTCCTGCGTATTGAACCG
CCGTCGAGAAGAAATTGCA: CGTCGAGAAGAAATTGCAA
CCGTCGGGGGAGCTCTTAA: CGTCGGGGGAGCTCTTAAA
CCGTCGTCTAGACGAGTAC: CGTCGTCTAGACGAGTACC
CCGTGCTTGAAGCAGGTAC: CGTGCTTGAAGCAGGTACT
CCGTGGCATCCTTGCGCAC: CGTGGCATCCTTGCGCACC
CCGTGGCTGCGAACTCGCC: CGTGGCTGCGAACTCGCCA
CCGTGTTTGACATTCACGT: CGTGTTTGACATTCACGTT
CCGTTGATCTCACGACCCA: CGTTGATCTCACGACCCAT
CCTAACAGGTATTTGACAA: CTAACAGGTATTTGACAAT
CCTAACGTCTTGAAGGACG: CTAACGTCTTGAAGGACGT
CCTACCGTCGTCTAGACGA: CTACCGTCGTCTAGACGAG
CCTAGATGAGTTATGATTT: CTAGATGAGTTATGATTTG
CCTAGCTACAGAATGAGTT: CTAGCTACAGAATGAGTTT
CCTAGTCAACATAATGGAC: CTAGTCAACATAATGGACA
CCTATAACCCCCATATCAG: CTATAACCCCCATATCAGG
CCTATGGCGAATACTTCCA: CTATGGCGAATACTTCCAT
CCTATGTAAAAGCGAGATG: CTATGTAAAAGCGAGATGT
CCTCAGACTTCTCGTGCCG: CTCAGACTTCTCGTGCCGA
CCTCAGCTTTATCCCGCCG: CTCAGCTTTATCCCGCCGC
CCTCCGCTCAGAACGCAAG: CTCCGCTCAGAACGCAAGT
CCTCCGGAACTAACGGCAA: CTCCGGAACTAACGGCAAA
CCTCTCAGGGTAGACATGT: CTCTCAGGGTAGACATGTA
CCTCTTCTGCAACTAGCGC: CTCTTCTGCAACTAGCGCA
CCTCTTCTGCTCTCATGAG: CTCTTCTGCTCTCATGAGA
CCTGAGCCTTGGGCGATGT: CTGAGCCTTGGGCGATGTG
CCTGAGTCAGCGTCAAGCG: CTGAGTCAGCGTCAAGCGG
CCTGAGTCGGATCACTCCA: CTGAGTCGGATCACTCCAC
CCTGCCACCAGTGATCGTT: CTGCCACCAGTGATCGTTG
CCTGCCTGAGTCAGCGTCA: CTGCCTGAGTCAGCGTCAA
CCTGCGTATTGAACCGTCG: CTGCGTATTGAACCGTCGG
CCTGGACGCCAACCATGAC: CTGGACGCCAACCATGACC
CCTGTGGCTAGGAAATACC: CTGTGGCTAGGAAATACCG
CCTTATGGACAGCATACTA: CTTATGGACAGCATACTAT
CCTTCGATTGGGCGGCTCT: CTTCGATTGGGCGGCTCTC
CCTTCGTGGTGCCATTTCG: CTTCGTGGTGCCATTTCGA
CCTTCTCAATTAGCAATCA: CTTCTCAATTAGCAATCAC
CCTTCTCACCAAGAATGCT: CTTCTCACCAAGAATGCTA
CCTTCTGTATGGCTCAAGT: CTTCTGTATGGCTCAAGTA
CCTTCTTAGGCTACCCGTA: CTTCTTAGGCTACCCGTAT
CCTTGCAGTGTGCGCAAAA: CTTGCAGTGTGCGCAAAAA
CCTTGGGCGATGTGGTGGC: CTTGGGCGATGTGGTGGCA
CCTTGTTTGAGGCATGATC: CTTGTTTGAGGCATGATCC
CCTTTGATTCTAGTCCTCA: CTTTGATTCTAGTCCTCAG
CGAACACATACTACGTCGG: GAACACATACTACGTCGGA
CGAACCTTCTTAGGCTACC: GAACCTTCTTAGGCTACCC
CGAACTCGCCATACTTGGG: GAACTCGCCATACTTGGGG
CGAAGGCTGGGTTGCCTAT: GAAGGCTGGGTTGCCTATG
CGAAGGTGACACCTTCTGT: GAAGGTGACACCTTCTGTA
CGAATACTTCCATCCTCTT: GAATACTTCCATCCTCTTC
CGAATAGGTAGACAATACG: GAATAGGTAGACAATACGG
CGAATCCTGCCTGAGTCAG: GAATCCTGCCTGAGTCAGC
CGAATCGCAGGTGCTGTCG: GAATCGCAGGTGCTGTCGG
CGAATTCCCGACACAAGAT: GAATTCCCGACACAAGATC
CGAATTGTTTAATCCCTAG: GAATTGTTTAATCCCTAGA
CGACACAAGATCCTGTGGC: GACACAAGATCCTGTGGCT
CGACATATTTTTAATTCCA: GACATATTTTTAATTCCAG
CGACATTAAGACATCGTAC: GACATTAAGACATCGTACA
CGACCATCGTACAACAGCA: GACCATCGTACAACAGCAT
CGACCCATTTTCCTCCGGA: GACCCATTTTCCTCCGGAA
CGACCGTTGATCTCACGAC: GACCGTTGATCTCACGACC
CGACTGACTATTACATATG: GACTGACTATTACATATGC
CGACTTGAAGGAACGTGGC: GACTTGAAGGAACGTGGCT
CGACTTTTGCATGATTAGG: GACTTTTGCATGATTAGGC
CGAGAAGAAATTGCAAGGC: GAGAAGAAATTGCAAGGCT
CGAGATGTCTGCAACACGT: GAGATGTCTGCAACACGTT
CGAGCGTGTTGAGGGGGCC: GAGCGTGTTGAGGGGGCCC
CGAGGATTGTGCGAGCGTG: GAGGATTGTGCGAGCGTGT
CGAGGGCCGTAATCATGCC: GAGGGCCGTAATCATGCCT
CGAGTACCACTAGCCCCTA: GAGTACCACTAGCCCCTAA
CGAGTTGTAAAGGATCTTA: GAGTTGTAAAGGATCTTAA
CGATCCTACCGTCGTCTAG: GATCCTACCGTCGTCTAGA
CGATGACTGATATCTCCGA: GATGACTGATATCTCCGAA
CGATGGGGCATCGTACAAC: GATGGGGCATCGTACAACA
CGATGTGGTGGCAATGTAG: GATGTGGTGGCAATGTAGC
CGATTGGGCGGCTCTCAGC: GATTGGGCGGCTCTCAGCT
CGCAAAAATCAACGGGACC: GCAAAAATCAACGGGACCG
CGCAAATGGCTATCCCCTG: GCAAATGGCTATCCCCTGC
CGCAACTACTCCCCTCTCA: GCAACTACTCCCCTCTCAG
CGCAAGTACAACTCGAGTT: GCAAGTACAACTCGAGTTG
CGCAGGTGCTGTCGGGCGC: GCAGGTGCTGTCGGGCGCA
CGCAGTGAACTGAATCGTC: GCAGTGAACTGAATCGTCG
CGCAGTGTACCTGAGCCTT: GCAGTGTACCTGAGCCTTG
CGCATTCGCGGCCGTACAG: GCATTCGCGGCCGTACAGA
CGCCAACCATGACCACATC: GCCAACCATGACCACATCA
CGCCATACTTGGGGCCGGC: GCCATACTTGGGGCCGGCC
CGCCCTATAACCCCCATAT: GCCCTATAACCCCCATATC
CGCCGCATTCGCGGCCGTA: GCCGCATTCGCGGCCGTAC
CGCCTCAGACTTCTCGTGC: GCCTCAGACTTCTCGTGCC
CGCGATGGGGCATCGTACA: GCGATGGGGCATCGTACAA
CGCGCCTCAGACTTCTCGT: GCGCCTCAGACTTCTCGTG
CGCGGCCGTACAGAGAGCA: GCGGCCGTACAGAGAGCAG
CGCGGCTCCTTATGGACAG: GCGGCTCCTTATGGACAGC
CGCGTCTCGTCCTCTTCTG: GCGTCTCGTCCTCTTCTGC
CGCTAGATGTATCTTACGT: GCTAGATGTATCTTACGTG
CGCTATACTAAGCGTTGAC: GCTATACTAAGCGTTGACG
CGCTCAGAACGCAAGTACA: GCTCAGAACGCAAGTACAA
CGCTTCCGTCCTGCGTATT: GCTTCCGTCCTGCGTATTG
CGGAACTAACGGCAAATTA: GGAACTAACGGCAAATTAA
CGGATCACTCCACAGTACC: GGATCACTCCACAGTACCT
CGGATCGATGACTGATATC: GGATCGATGACTGATATCT
CGGCAAATTAATGCCTGAG: GGCAAATTAATGCCTGAGT
CGGCAAGTCGTCGAGGGCC: GGCAAGTCGTCGAGGGCCG
CGGCAGCCCCGAAGGCTGG: GGCAGCCCCGAAGGCTGGG
CGGCCGAGGATTGTGCGAG: GGCCGAGGATTGTGCGAGC
CGGCCGTACAGAGAGCAGC: GGCCGTACAGAGAGCAGCC
CGGCGGGTATAGGGAGACT: GGCGGGTATAGGGAGACTT
CGGCGGTGCCGTCAGCATG: GGCGGTGCCGTCAGCATGC
CGGCGTCATCAGGACAGTA: GGCGTCATCAGGACAGTAA
CGGCTACCGCTATACTAAG: GGCTACCGCTATACTAAGC
CGGCTCCTTATGGACAGCA: GGCTCCTTATGGACAGCAT
CGGCTCTCAGCTACCCGAC: GGCTCTCAGCTACCCGACA
CGGGACCGGCGGGTATAGG: GGGACCGGCGGGTATAGGG
CGGGAGTGACCGTGGCATC: GGGAGTGACCGTGGCATCC
CGGGCATGCACGTGTTTTC: GGGCATGCACGTGTTTTCA
CGGGCCCCGGGCATGCACG: GGGCCCCGGGCATGCACGT
CGGGCGAATCCTGCCTGAG: GGGCGAATCCTGCCTGAGT
CGGGCGCAAATGGCTATCC: GGGCGCAAATGGCTATCCC
CGGGGGAGCTCTTAAAACA: GGGGGAGCTCTTAAAACAC
CGGGTATAGGGAGACTTAG: GGGTATAGGGAGACTTAGA
CGGTCACTTATCTTCGTTC: GGTCACTTATCTTCGTTCA
CGGTGATGGAGTAGTAGAT: GGTGATGGAGTAGTAGATA
CGGTGCCGTCAGCATGCCG: GGTGCCGTCAGCATGCCGG
CGGTTCGTGGAGCGCGATG: GGTTCGTGGAGCGCGATGG
CGGTTGCTGGAATGTTCTC: GGTTGCTGGAATGTTCTCT
CGTAAGCAGATATACCTTC: GTAAGCAGATATACCTTCT
CGTAATAGGAATGATCGGT: GTAATAGGAATGATCGGTG
CGTAATCATGCCTGGACGC: GTAATCATGCCTGGACGCC
CGTAATGCGTTCAGACTTC: GTAATGCGTTCAGACTTCT
CGTAATTTTAGGGTTTACG: GTAATTTTAGGGTTTACGG
CGTACAACAGCATCAAGGC: GTACAACAGCATCAAGGCA
CGTACAACAGCATCACTAT: GTACAACAGCATCACTATG
CGTACAACAGCATCAGCGT: GTACAACAGCATCAGCGTA
CGTACAACAGCATCATAAT: GTACAACAGCATCATAATG
CGTACAGAGAGCAGCCAGT: GTACAGAGAGCAGCCAGTA
CGTATCAAGTGACCCTTCG: GTATCAAGTGACCCTTCGT
CGTATTGAACCGTCGGGGG: GTATTGAACCGTCGGGGGA
CGTCAAATATTGCGAATTG: GTCAAATATTGCGAATTGT
CGTCAACGTGCAAGTGCCG: GTCAACGTGCAAGTGCCGT
CGTCAAGCGGGAGTGACCG: GTCAAGCGGGAGTGACCGT
CGTCAGCATGCCGGGCCCC: GTCAGCATGCCGGGCCCCG
CGTCATCAGGACAGTAAAT: GTCATCAGGACAGTAAATC
CGTCCTCTTCTGCTCTCAT: GTCCTCTTCTGCTCTCATG
CGTCCTGCGTATTGAACCG: GTCCTGCGTATTGAACCGT
CGTCGAATCGCAGGTGCTG: GTCGAATCGCAGGTGCTGT
CGTCGAGAAGAAATTGCAA: GTCGAGAAGAAATTGCAAG
CGTCGAGGGCCGTAATCAT: GTCGAGGGCCGTAATCATG
CGTCGCGGCTCCTTATGGA: GTCGCGGCTCCTTATGGAC
CGTCGGATCGATGACTGAT: GTCGGATCGATGACTGATA
CGTCGGGGGAGCTCTTAAA: GTCGGGGGAGCTCTTAAAA
CGTCGTCTAGACGAGTACC: GTCGTCTAGACGAGTACCA
CGTCTAGACGAGTACCACT: GTCTAGACGAGTACCACTA
CGTCTCGTCCTCTTCTGCT: GTCTCGTCCTCTTCTGCTC
CGTCTTGAAGGACGTAATA: GTCTTGAAGGACGTAATAG
CGTGACTGTAGTATTCTCT: GTGACTGTAGTATTCTCTC
CGTGCAAGTGCCGTGCTTG: GTGCAAGTGCCGTGCTTGA
CGTGCCCCCAACATTCTAC: GTGCCCCCAACATTCTACT
CGTGCCGACATATTTTTAA: GTGCCGACATATTTTTAAT
CGTGCCGACTGACTATTAC: GTGCCGACTGACTATTACA
CGTGCCGACTTGAAGGAAC: GTGCCGACTTGAAGGAACG
CGTGCCGACTTTTGCATGA: GTGCCGACTTTTGCATGAT
CGTGCTTGAAGCAGGTACT: GTGCTTGAAGCAGGTACTG
CGTGGAGCGCGATGGGGCA: GTGGAGCGCGATGGGGCAT
CGTGGCATCCTTGCGCACC: GTGGCATCCTTGCGCACCT
CGTGGCTCTATCTAGAACC: GTGGCTCTATCTAGAACCC
CGTGGCTGCGAACTCGCCA: GTGGCTGCGAACTCGCCAT
CGTGGTGCCATTTCGATCC: GTGGTGCCATTTCGATCCT
CGTGTTGAGGGGGCCCCAA: GTGTTGAGGGGGCCCCAAT
CGTGTTTGACATTCACGTT: GTGTTTGACATTCACGTTC
CGTGTTTTCAAGTCGGCAG: GTGTTTTCAAGTCGGCAGC
CGTTCAGACTTCTCGTGCC: GTTCAGACTTCTCGTGCCG
CGTTCAGCTATTCACCTCC: GTTCAGCTATTCACCTCCG
CGTTCCTAGTCAACATAAT: GTTCCTAGTCAACATAATG
CGTTGACGAACACATACTA: GTTGACGAACACATACTAC
CGTTGATCTCACGACCCAT: GTTGATCTCACGACCCATT
CGTTGCTCTCGCCCTATAA: GTTGCTCTCGCCCTATAAC
CGTTGTCGGTTGCTGGAAT: GTTGTCGGTTGCTGGAATG
CTAAAACATTTCGCTAGAT: TAAAACATTTCGCTAGATG
CTAACAGGTATTTGACAAT: TAACAGGTATTTGACAATA
CTAACCGGCGGTGCCGTCA: TAACCGGCGGTGCCGTCAG
CTAACCTTTGATTCTAGTC: TAACCTTTGATTCTAGTCC
CTAACGGCAAATTAATGCC: TAACGGCAAATTAATGCCT
CTAACGTCTTGAAGGACGT: TAACGTCTTGAAGGACGTA
CTAAGCGTTGACGAACACA: TAAGCGTTGACGAACACAT
CTAATCAACTCATTTCCGT: TAATCAACTCATTTCCGTG
CTACAGAATGAGTTTGAAG: TACAGAATGAGTTTGAAGA
CTACCCCTTCTCAATTAGC: TACCCCTTCTCAATTAGCA
CTACCCGACATTAAGACAT: TACCCGACATTAAGACATC
CTACCCGTATCAAGTGACC: TACCCGTATCAAGTGACCC
CTACCGCTATACTAAGCGT: TACCGCTATACTAAGCGTT
CTACCGTCGTCTAGACGAG: TACCGTCGTCTAGACGAGT
CTACGTCGGATCGATGACT: TACGTCGGATCGATGACTG
CTACTCCCCTCTCAGGGTA: TACTCCCCTCTCAGGGTAG
CTACTGTATATCTCTCAAA: TACTGTATATCTCTCAAAA
CTAGAACCCACCGGCTACC: TAGAACCCACCGGCTACCG
CTAGACGAGTACCACTAGC: TAGACGAGTACCACTAGCC
CTAGATGAGTTATGATTTG: TAGATGAGTTATGATTTGT
CTAGATGTATCTTACGTGC: TAGATGTATCTTACGTGCC
CTAGCCCCTAACAGGTATT: TAGCCCCTAACAGGTATTT
CTAGCGCAACTACTCCCCT: TAGCGCAACTACTCCCCTC
CTAGCTACAGAATGAGTTT: TAGCTACAGAATGAGTTTG
CTAGGAAATACCGCGTCTC: TAGGAAATACCGCGTCTCG
CTAGTCAACATAATGGACA: TAGTCAACATAATGGACAT
CTAGTCCTCAGCTTTATCC: TAGTCCTCAGCTTTATCCC
CTATAACCCCCATATCAGG: TATAACCCCCATATCAGGT
CTATACTAAGCGTTGACGA: TATACTAAGCGTTGACGAA
CTATAGACGAATTCCCGAC: TATAGACGAATTCCCGACA
CTATCCCCTGCCACCAGTG: TATCCCCTGCCACCAGTGA
CTATCTAGAACCCACCGGC: TATCTAGAACCCACCGGCT
CTATGCGCGCCTCAGACTT: TATGCGCGCCTCAGACTTC
CTATGGCGAATACTTCCAT: TATGGCGAATACTTCCATC
CTATGGCGTAATTTTAGGG: TATGGCGTAATTTTAGGGT
CTATGTAAAAGCGAGATGT: TATGTAAAAGCGAGATGTC
CTATTACATATGCGGCGTC: TATTACATATGCGGCGTCA
CTATTACTAATCAACTCAT: TATTACTAATCAACTCATT
CTATTCACCTCCGCTCAGA: TATTCACCTCCGCTCAGAA
CTCAAAATATCTCTCCTTC: TCAAAATATCTCTCCTTCG
CTCAAGTAAAGCAGGGTTA: TCAAGTAAAGCAGGGTTAT
CTCAATTAGCAATCACTGA: TCAATTAGCAATCACTGAA
CTCACCAAGAATGCTAACC: TCACCAAGAATGCTAACCG
CTCACGACCCATTTTCCTC: TCACGACCCATTTTCCTCC
CTCAGAACAACGGCAAGTC: TCAGAACAACGGCAAGTCG
CTCAGAACGCAAGTACAAC: TCAGAACGCAAGTACAACT
CTCAGACTTCTCGTGCCGA: TCAGACTTCTCGTGCCGAC
CTCAGCTACCCGACATTAA: TCAGCTACCCGACATTAAG
CTCAGCTTTATCCCGCCGC: TCAGCTTTATCCCGCCGCA
CTCAGGGTAGACATGTATT: TCAGGGTAGACATGTATTA
CTCATGAGACGGTTCGTGG: TCATGAGACGGTTCGTGGA
CTCATGAGTGGATATGGCT: TCATGAGTGGATATGGCTG
CTCATTTCCGTGGCTGCGA: TCATTTCCGTGGCTGCGAA
CTCCACAGTACCTAGCTAC: TCCACAGTACCTAGCTACA
CTCCCCTCTCAGGGTAGAC: TCCCCTCTCAGGGTAGACA
CTCCGAAGGTGACACCTTC: TCCGAAGGTGACACCTTCT
CTCCGCTCAGAACGCAAGT: TCCGCTCAGAACGCAAGTA
CTCCGGAACTAACGGCAAA: TCCGGAACTAACGGCAAAT
CTCCTTATGGACAGCATAC: TCCTTATGGACAGCATACT
CTCCTTCGATTGGGCGGCT: TCCTTCGATTGGGCGGCTC
CTCGACCATCGTACAACAG: TCGACCATCGTACAACAGC
CTCGAGTTGTAAAGGATCT: TCGAGTTGTAAAGGATCTT
CTCGCCATACTTGGGGCCG: TCGCCATACTTGGGGCCGG
CTCGCCCTATAACCCCCAT: TCGCCCTATAACCCCCATA
CTCGCTTCCGTCCTGCGTA: TCGCTTCCGTCCTGCGTAT
CTCGTCCTCTTCTGCTCTC: TCGTCCTCTTCTGCTCTCA
CTCGTGCCGACATATTTTT: TCGTGCCGACATATTTTTA
CTCGTGCCGACTGACTATT: TCGTGCCGACTGACTATTA
CTCGTGCCGACTTGAAGGA: TCGTGCCGACTTGAAGGAA
CTCGTGCCGACTTTTGCAT: TCGTGCCGACTTTTGCATG
CTCTACCCCTTCTCAATTA: TCTACCCCTTCTCAATTAG
CTCTATCTAGAACCCACCG: TCTATCTAGAACCCACCGG
CTCTCAAAATATCTCTCCT: TCTCAAAATATCTCTCCTT
CTCTCAGAACAACGGCAAG: TCTCAGAACAACGGCAAGT
CTCTCAGCTACCCGACATT: TCTCAGCTACCCGACATTA
CTCTCAGGGTAGACATGTA: TCTCAGGGTAGACATGTAT
CTCTCATGAGACGGTTCGT: TCTCATGAGACGGTTCGTG
CTCTCCTTCGATTGGGCGG: TCTCCTTCGATTGGGCGGC
CTCTCGCCCTATAACCCCC: TCTCGCCCTATAACCCCCA
CTCTCTTCATCGTACAACA: TCTCTTCATCGTACAACAG
CTCTGCTTTTCGTGACTGT: TCTGCTTTTCGTGACTGTA
CTCTTAAAACACCCCAGAG: TCTTAAAACACCCCAGAGC
CTCTTCATCGTACAACAGC: TCTTCATCGTACAACAGCA
CTCTTCTGCAACTAGCGCA: TCTTCTGCAACTAGCGCAA
CTCTTCTGCTCTCATGAGA: TCTTCTGCTCTCATGAGAC
CTGAAGCTATTACTAATCA: TGAAGCTATTACTAATCAA
CTGAATCGTCGAATCGCAG: TGAATCGTCGAATCGCAGG
CTGACTATTACATATGCGG: TGACTATTACATATGCGGC
CTGAGCCTTGGGCGATGTG: TGAGCCTTGGGCGATGTGG
CTGAGTCAGCGTCAAGCGG: TGAGTCAGCGTCAAGCGGG
CTGAGTCGGATCACTCCAC: TGAGTCGGATCACTCCACA
CTGATATCTCCGAAGGTGA: TGATATCTCCGAAGGTGAC
CTGCAACACGTTGTCGGTT: TGCAACACGTTGTCGGTTG
CTGCAACTAGCGCAACTAC: TGCAACTAGCGCAACTACT
CTGCCACCAGTGATCGTTG: TGCCACCAGTGATCGTTGC
CTGCCTGAGTCAGCGTCAA: TGCCTGAGTCAGCGTCAAG
CTGCGAACTCGCCATACTT: TGCGAACTCGCCATACTTG
CTGCGTATTGAACCGTCGG: TGCGTATTGAACCGTCGGG
CTGCTCTCATGAGACGGTT: TGCTCTCATGAGACGGTTC
CTGCTTTTCGTGACTGTAG: TGCTTTTCGTGACTGTAGT
CTGGAATGTTCTCTCAGAA: TGGAATGTTCTCTCAGAAC
CTGGACGCCAACCATGACC: TGGACGCCAACCATGACCA
CTGGCCACATTCAGCGTCG: TGGCCACATTCAGCGTCGC
CTGGGTTGCCTATGGCGAA: TGGGTTGCCTATGGCGAAT
CTGTAGTATTCTCTCTTCA: TGTAGTATTCTCTCTTCAT
CTGTATATCTCTCAAAATA: TGTATATCTCTCAAAATAT
CTGTATCATCCCCCAGCTA: TGTATCATCCCCCAGCTAT
CTGTATGGCTCAAGTAAAG: TGTATGGCTCAAGTAAAGC
CTGTCGGGCGCAAATGGCT: TGTCGGGCGCAAATGGCTA
CTGTGGCTAGGAAATACCG: TGTGGCTAGGAAATACCGC
CTGTGTGTAGCTCGCTTCC: TGTGTGTAGCTCGCTTCCG
CTTAAAACACCCCAGAGCA: TTAAAACACCCCAGAGCAC
CTTAACATGATCTCATGAG: TTAACATGATCTCATGAGT
CTTACAGGACATAGTATTG: TTACAGGACATAGTATTGT
CTTACGTGCCCCCAACATT: TTACGTGCCCCCAACATTC
CTTAGACCCAGCAGGATCC: TTAGACCCAGCAGGATCCG
CTTAGGCTACCCGTATCAA: TTAGGCTACCCGTATCAAG
CTTATCTTCGTTCAGCTAT: TTATCTTCGTTCAGCTATT
CTTATGGACAGCATACTAT: TTATGGACAGCATACTATA
CTTCATCGTACAACAGCAT: TTCATCGTACAACAGCATC
CTTCCATCCTCTTCTGCAA: TTCCATCCTCTTCTGCAAC
CTTCCGTCCTGCGTATTGA: TTCCGTCCTGCGTATTGAA
CTTCGATTGGGCGGCTCTC: TTCGATTGGGCGGCTCTCA
CTTCGTGGTGCCATTTCGA: TTCGTGGTGCCATTTCGAT
CTTCGTTCAGCTATTCACC: TTCGTTCAGCTATTCACCT
CTTCTCAATTAGCAATCAC: TTCTCAATTAGCAATCACT
CTTCTCACCAAGAATGCTA: TTCTCACCAAGAATGCTAA
CTTCTCGTGCCGACATATT: TTCTCGTGCCGACATATTT
CTTCTCGTGCCGACTGACT: TTCTCGTGCCGACTGACTA
CTTCTCGTGCCGACTTGAA: TTCTCGTGCCGACTTGAAG
CTTCTCGTGCCGACTTTTG: TTCTCGTGCCGACTTTTGC
CTTCTGCAACTAGCGCAAC: TTCTGCAACTAGCGCAACT
CTTCTGCTCTCATGAGACG: TTCTGCTCTCATGAGACGG
CTTCTGTATGGCTCAAGTA: TTCTGTATGGCTCAAGTAA
CTTCTTAGGCTACCCGTAT: TTCTTAGGCTACCCGTATC
CTTGAAGCAGGTACTGTGT: TTGAAGCAGGTACTGTGTG
CTTGAAGGAACGTGGCTCT: TTGAAGGAACGTGGCTCTA
CTTGAAGGACGTAATAGGA: TTGAAGGACGTAATAGGAA
CTTGACACAGAGATGGCTA: TTGACACAGAGATGGCTAA
CTTGCAGTGTGCGCAAAAA: TTGCAGTGTGCGCAAAAAT
CTTGCTCTACCCCTTCTCA: TTGCTCTACCCCTTCTCAA
CTTGGGCGATGTGGTGGCA: TTGGGCGATGTGGTGGCAA
CTTGGGGCCGGCCGAGGAT: TTGGGGCCGGCCGAGGATT
CTTGTTTGAGGCATGATCC: TTGTTTGAGGCATGATCCG
CTTTATCCCGCCGCATTCG: TTTATCCCGCCGCATTCGC
CTTTGATTCTAGTCCTCAG: TTTGATTCTAGTCCTCAGC
CTTTTCGTGACTGTAGTAT: TTTTCGTGACTGTAGTATT
CTTTTGCATGATTAGGCTT: TTTTGCATGATTAGGCTTG
GAAATACCGCGTCTCGTCC: AAATACCGCGTCTCGTCCT
GAAATTGCAAGGCTTGCTC: AAATTGCAAGGCTTGCTCT
GAACAACGGCAAGTCGTCG: AACAACGGCAAGTCGTCGA
GAACACATACTACGTCGGA: AACACATACTACGTCGGAT
GAACCCACCGGCTACCGCT: AACCCACCGGCTACCGCTA
GAACCGTCGGGGGAGCTCT: AACCGTCGGGGGAGCTCTT
GAACCTTCTTAGGCTACCC: AACCTTCTTAGGCTACCCG
GAACGCAAGTACAACTCGA: AACGCAAGTACAACTCGAG
GAACGTGGCTCTATCTAGA: AACGTGGCTCTATCTAGAA
GAACTAACGGCAAATTAAT: AACTAACGGCAAATTAATG
GAACTCGCCATACTTGGGG: AACTCGCCATACTTGGGGC
GAACTGAATCGTCGAATCG: AACTGAATCGTCGAATCGC
GAAGAAATTGCAAGGCTTG: AAGAAATTGCAAGGCTTGC
GAAGAAGGTTTAAGGGCCA: AAGAAGGTTTAAGGGCCAG
GAAGCAGGTACTGTGTGTA: AAGCAGGTACTGTGTGTAG
GAAGCTATTACTAATCAAC: AAGCTATTACTAATCAACT
GAAGGAACGTGGCTCTATC: AAGGAACGTGGCTCTATCT
GAAGGACGTAATAGGAATG: AAGGACGTAATAGGAATGA
GAAGGATCAGACTTCTCGT: AAGGATCAGACTTCTCGTG
GAAGGCTGGGTTGCCTATG: AAGGCTGGGTTGCCTATGG
GAAGGTGACACCTTCTGTA: AAGGTGACACCTTCTGTAT
GAAGGTTTAAGGGCCAGGA: AAGGTTTAAGGGCCAGGAC
GAATACTTCCATCCTCTTC: AATACTTCCATCCTCTTCT
GAATAGGTAGACAATACGG: AATAGGTAGACAATACGGT
GAATCCTGCCTGAGTCAGC: AATCCTGCCTGAGTCAGCG
GAATCGCAGGTGCTGTCGG: AATCGCAGGTGCTGTCGGG
GAATCGTCGAATCGCAGGT: AATCGTCGAATCGCAGGTG
GAATGAGTTTGAAGAAGGT: AATGAGTTTGAAGAAGGTT
GAATGATCGGTGATGGAGT: AATGATCGGTGATGGAGTA
GAATGCTAACCGGCGGTGC: AATGCTAACCGGCGGTGCC
GAATGTTCTCTCAGAACAA: AATGTTCTCTCAGAACAAC
GAATTCCCGACACAAGATC: AATTCCCGACACAAGATCC
GAATTGTTTAATCCCTAGA: AATTGTTTAATCCCTAGAT
GACAATACGGTCACTTATC: ACAATACGGTCACTTATCT
GACAATAGGTTGCTTACAG: ACAATAGGTTGCTTACAGG
GACACAAGATCCTGTGGCT: ACACAAGATCCTGTGGCTA
GACACAGAGATGGCTAACC: ACACAGAGATGGCTAACCT
GACACCTTCTGTATGGCTC: ACACCTTCTGTATGGCTCA
GACAGCATACTATAGACGA: ACAGCATACTATAGACGAA
GACAGTAAATCCTTGTTTG: ACAGTAAATCCTTGTTTGA
GACATAGTATTGTTAGCAA: ACATAGTATTGTTAGCAAA
GACATATTTTTAATTCCAG: ACATATTTTTAATTCCAGT
GACATCGTACAACAGCATC: ACATCGTACAACAGCATCA
GACATGGTTCTCGACCATC: ACATGGTTCTCGACCATCG
GACATGTATTAGACCTATG: ACATGTATTAGACCTATGT
GACATTAAGACATCGTACA: ACATTAAGACATCGTACAA
GACATTCACGTTCCTAGTC: ACATTCACGTTCCTAGTCA
GACCACATCAATAGCGCAG: ACCACATCAATAGCGCAGT
GACCATCGTACAACAGCAT: ACCATCGTACAACAGCATC
GACCCAGCAGGATCCGACC: ACCCAGCAGGATCCGACCG
GACCCATTTTCCTCCGGAA: ACCCATTTTCCTCCGGAAC
GACCCTTCGTGGTGCCATT: ACCCTTCGTGGTGCCATTT
GACCGGCGGGTATAGGGAG: ACCGGCGGGTATAGGGAGA
GACCGTGGCATCCTTGCGC: ACCGTGGCATCCTTGCGCA
GACCGTTGATCTCACGACC: ACCGTTGATCTCACGACCC
GACCTATGTAAAAGCGAGA: ACCTATGTAAAAGCGAGAT
GACGAACACATACTACGTC: ACGAACACATACTACGTCG
GACGAATTCCCGACACAAG: ACGAATTCCCGACACAAGA
GACGAGTACCACTAGCCCC: ACGAGTACCACTAGCCCCT
GACGCCAACCATGACCACA: ACGCCAACCATGACCACAT
GACGGTTCGTGGAGCGCGA: ACGGTTCGTGGAGCGCGAT
GACGTAATAGGAATGATCG: ACGTAATAGGAATGATCGG
GACGTCAACGTGCAAGTGC: ACGTCAACGTGCAAGTGCC
GACTATTACATATGCGGCG: ACTATTACATATGCGGCGT
GACTCTGCTTTTCGTGACT: ACTCTGCTTTTCGTGACTG
GACTGACTATTACATATGC: ACTGACTATTACATATGCG
GACTGATATCTCCGAAGGT: ACTGATATCTCCGAAGGTG
GACTGTAGTATTCTCTCTT: ACTGTAGTATTCTCTCTTC
GACTTAGACCCAGCAGGAT: ACTTAGACCCAGCAGGATC
GACTTCTCGTGCCGACATA: ACTTCTCGTGCCGACATAT
GACTTCTCGTGCCGACTGA: ACTTCTCGTGCCGACTGAC
GACTTCTCGTGCCGACTTG: ACTTCTCGTGCCGACTTGA
GACTTCTCGTGCCGACTTT: ACTTCTCGTGCCGACTTTT
GACTTGAAGGAACGTGGCT: ACTTGAAGGAACGTGGCTC
GACTTTTGCATGATTAGGC: ACTTTTGCATGATTAGGCT
GAGAAGAAATTGCAAGGCT: AGAAGAAATTGCAAGGCTT
GAGACGGTTCGTGGAGCGC: AGACGGTTCGTGGAGCGCG
GAGACTTAGACCCAGCAGG: AGACTTAGACCCAGCAGGA
GAGAGCAGCCAGTAGTGCC: AGAGCAGCCAGTAGTGCCA
GAGATGGCTAACCTTTGAT: AGATGGCTAACCTTTGATT
GAGATGTCTGCAACACGTT: AGATGTCTGCAACACGTTG
GAGCACACTGTATCATCCC: AGCACACTGTATCATCCCC
GAGCAGCCAGTAGTGCCAG: AGCAGCCAGTAGTGCCAGG
GAGCCTTGGGCGATGTGGT: AGCCTTGGGCGATGTGGTG
GAGCGCGATGGGGCATCGT: AGCGCGATGGGGCATCGTA
GAGCGTGTTGAGGGGGCCC: AGCGTGTTGAGGGGGCCCC
GAGCTCTTAAAACACCCCA: AGCTCTTAAAACACCCCAG
GAGGATTGTGCGAGCGTGT: AGGATTGTGCGAGCGTGTT
GAGGCATGATCCGAACCTT: AGGCATGATCCGAACCTTC
GAGGGCCGTAATCATGCCT: AGGGCCGTAATCATGCCTG
GAGGGGGCCCCAATCCAGT: AGGGGGCCCCAATCCAGTC
GAGTACCACTAGCCCCTAA: AGTACCACTAGCCCCTAAC
GAGTAGTAGATACGCAGTG: AGTAGTAGATACGCAGTGT
GAGTCAGCGTCAAGCGGGA: AGTCAGCGTCAAGCGGGAG
GAGTCGGATCACTCCACAG: AGTCGGATCACTCCACAGT
GAGTGACCGTGGCATCCTT: AGTGACCGTGGCATCCTTG
GAGTGGATATGGCTGGCCA: AGTGGATATGGCTGGCCAC
GAGTTATGATTTGTGACTC: AGTTATGATTTGTGACTCT
GAGTTGTAAAGGATCTTAA: AGTTGTAAAGGATCTTAAC
GAGTTTGAAGAAGGTTTAA: AGTTTGAAGAAGGTTTAAG
GATACGCAGTGTACCTGAG: ATACGCAGTGTACCTGAGC
GATATACCTTCTCACCAAG: ATATACCTTCTCACCAAGA
GATATCTCCGAAGGTGACA: ATATCTCCGAAGGTGACAC
GATATGGCTGGCCACATTC: ATATGGCTGGCCACATTCA
GATCACTCCACAGTACCTA: ATCACTCCACAGTACCTAG
GATCAGACTTCTCGTGCCG: ATCAGACTTCTCGTGCCGA
GATCCGAACCTTCTTAGGC: ATCCGAACCTTCTTAGGCT
GATCCGACCGTTGATCTCA: ATCCGACCGTTGATCTCAC
GATCCTACCGTCGTCTAGA: ATCCTACCGTCGTCTAGAC
GATCCTGTGGCTAGGAAAT: ATCCTGTGGCTAGGAAATA
GATCGATGACTGATATCTC: ATCGATGACTGATATCTCC
GATCGGTGATGGAGTAGTA: ATCGGTGATGGAGTAGTAG
GATCGTTGCTCTCGCCCTA: ATCGTTGCTCTCGCCCTAT
GATCTCACGACCCATTTTC: ATCTCACGACCCATTTTCC
GATCTCATGAGTGGATATG: ATCTCATGAGTGGATATGG
GATCTTAACATGATCTCAT: ATCTTAACATGATCTCATG
GATGACTGATATCTCCGAA: ATGACTGATATCTCCGAAG
GATGAGTTATGATTTGTGA: ATGAGTTATGATTTGTGAC
GATGGAGTAGTAGATACGC: ATGGAGTAGTAGATACGCA
GATGGCTAACCTTTGATTC: ATGGCTAACCTTTGATTCT
GATGGGGCATCGTACAACA: ATGGGGCATCGTACAACAG
GATGTATCTTACGTGCCCC: ATGTATCTTACGTGCCCCC
GATGTCTGCAACACGTTGT: ATGTCTGCAACACGTTGTC
GATGTGGTGGCAATGTAGC: ATGTGGTGGCAATGTAGCC
GATTAGGCTTGACACAGAG: ATTAGGCTTGACACAGAGA
GATTCTAGTCCTCAGCTTT: ATTCTAGTCCTCAGCTTTA
GATTGGGCGGCTCTCAGCT: ATTGGGCGGCTCTCAGCTA
GATTGTGCGAGCGTGTTGA: ATTGTGCGAGCGTGTTGAG
GATTTGTGACTCTGCTTTT: ATTTGTGACTCTGCTTTTC
GCAAAAATCAACGGGACCG: CAAAAATCAACGGGACCGG
GCAAACAGGCCTAACGTCT: CAAACAGGCCTAACGTCTT
GCAAATGGCTATCCCCTGC: CAAATGGCTATCCCCTGCC
GCAAATTAATGCCTGAGTC: CAAATTAATGCCTGAGTCG
GCAACACGTTGTCGGTTGC: CAACACGTTGTCGGTTGCT
GCAACTACTCCCCTCTCAG: CAACTACTCCCCTCTCAGG
GCAACTAGCGCAACTACTC: CAACTAGCGCAACTACTCC
GCAAGGCTTGCTCTACCCC: CAAGGCTTGCTCTACCCCT
GCAAGTACAACTCGAGTTG: CAAGTACAACTCGAGTTGT
GCAAGTCGTCGAGGGCCGT: CAAGTCGTCGAGGGCCGTA
GCAAGTGCCGTGCTTGAAG: CAAGTGCCGTGCTTGAAGC
GCAATCACTGAAGCTATTA: CAATCACTGAAGCTATTAC
GCAATGTAGCCGAATAGGT: CAATGTAGCCGAATAGGTA
GCACACTGTATCATCCCCC: CACACTGTATCATCCCCCA
GCACGTGTTTTCAAGTCGG: CACGTGTTTTCAAGTCGGC
GCAGATATACCTTCTCACC: CAGATATACCTTCTCACCA
GCAGCCAGTAGTGCCAGGT: CAGCCAGTAGTGCCAGGTC
GCAGCCCCGAAGGCTGGGT: CAGCCCCGAAGGCTGGGTT
GCAGGATCCGACCGTTGAT: CAGGATCCGACCGTTGATC
GCAGGGTTATAAACACATC: CAGGGTTATAAACACATCC
GCAGGTACTGTGTGTAGCT: CAGGTACTGTGTGTAGCTC
GCAGGTGCTGTCGGGCGCA: CAGGTGCTGTCGGGCGCAA
GCAGTGAACTGAATCGTCG: CAGTGAACTGAATCGTCGA
GCAGTGTACCTGAGCCTTG: CAGTGTACCTGAGCCTTGG
GCAGTGTGCGCAAAAATCA: CAGTGTGCGCAAAAATCAA
GCATAATTGTCAGACTTCT: CATAATTGTCAGACTTCTC
GCATACTATAGACGAATTC: CATACTATAGACGAATTCC
GCATCAAGGCATAATTGTC: CATCAAGGCATAATTGTCA
GCATCACTATGCGCGCCTC: CATCACTATGCGCGCCTCA
GCATCAGCGTAATGCGTTC: CATCAGCGTAATGCGTTCA
GCATCATAATGGAAGGATC: CATCATAATGGAAGGATCA
GCATCCTTGCGCACCTTGA: CATCCTTGCGCACCTTGAC
GCATCGTACAACAGCATCA: CATCGTACAACAGCATCAG
GCATGATCCGAACCTTCTT: CATGATCCGAACCTTCTTA
GCATGATTAGGCTTGACAC: CATGATTAGGCTTGACACA
GCATGCACGTGTTTTCAAG: CATGCACGTGTTTTCAAGT
GCATGCCGGGCCCCGGGCA: CATGCCGGGCCCCGGGCAT
GCATTCGCGGCCGTACAGA: CATTCGCGGCCGTACAGAG
GCCAACCATGACCACATCA: CCAACCATGACCACATCAA
GCCACATTCAGCGTCGCGG: CCACATTCAGCGTCGCGGC
GCCACCAGTGATCGTTGCT: CCACCAGTGATCGTTGCTC
GCCAGGACGTCAACGTGCA: CCAGGACGTCAACGTGCAA
GCCAGGTCGTAAGCAGATA: CCAGGTCGTAAGCAGATAT
GCCAGTAGTGCCAGGTCGT: CCAGTAGTGCCAGGTCGTA
GCCATACTTGGGGCCGGCC: CCATACTTGGGGCCGGCCG
GCCATTTCGATCCTACCGT: CCATTTCGATCCTACCGTC
GCCCCAATCCAGTCATTGG: CCCCAATCCAGTCATTGGG
GCCCCCAACATTCTACTGT: CCCCCAACATTCTACTGTA
GCCCCGAAGGCTGGGTTGC: CCCCGAAGGCTGGGTTGCC
GCCCCGGGCATGCACGTGT: CCCCGGGCATGCACGTGTT
GCCCCTAACAGGTATTTGA: CCCCTAACAGGTATTTGAC
GCCCTATAACCCCCATATC: CCCTATAACCCCCATATCA
GCCGAATAGGTAGACAATA: CCGAATAGGTAGACAATAC
GCCGACATATTTTTAATTC: CCGACATATTTTTAATTCC
GCCGACTGACTATTACATA: CCGACTGACTATTACATAT
GCCGACTTGAAGGAACGTG: CCGACTTGAAGGAACGTGG
GCCGACTTTTGCATGATTA: CCGACTTTTGCATGATTAG
GCCGAGGATTGTGCGAGCG: CCGAGGATTGTGCGAGCGT
GCCGCATTCGCGGCCGTAC: CCGCATTCGCGGCCGTACA
GCCGGCCGAGGATTGTGCG: CCGGCCGAGGATTGTGCGA
GCCGGGCCCCGGGCATGCA: CCGGGCCCCGGGCATGCAC
GCCGTAATCATGCCTGGAC: CCGTAATCATGCCTGGACG
GCCGTACAGAGAGCAGCCA: CCGTACAGAGAGCAGCCAG
GCCGTCAGCATGCCGGGCC: CCGTCAGCATGCCGGGCCC
GCCGTGCTTGAAGCAGGTA: CCGTGCTTGAAGCAGGTAC
GCCTAACGTCTTGAAGGAC: CCTAACGTCTTGAAGGACG
GCCTATGGCGAATACTTCC: CCTATGGCGAATACTTCCA
GCCTCAGACTTCTCGTGCC: CCTCAGACTTCTCGTGCCG
GCCTGAGTCAGCGTCAAGC: CCTGAGTCAGCGTCAAGCG
GCCTGAGTCGGATCACTCC: CCTGAGTCGGATCACTCCA
GCCTGGACGCCAACCATGA: CCTGGACGCCAACCATGAC
GCCTTGCAGTGTGCGCAAA: CCTTGCAGTGTGCGCAAAA
GCCTTGGGCGATGTGGTGG: CCTTGGGCGATGTGGTGGC
GCGAACTCGCCATACTTGG: CGAACTCGCCATACTTGGG
GCGAATACTTCCATCCTCT: CGAATACTTCCATCCTCTT
GCGAATCCTGCCTGAGTCA: CGAATCCTGCCTGAGTCAG
GCGAATTGTTTAATCCCTA: CGAATTGTTTAATCCCTAG
GCGAGATGTCTGCAACACG: CGAGATGTCTGCAACACGT
GCGAGCGTGTTGAGGGGGC: CGAGCGTGTTGAGGGGGCC
GCGATGGGGCATCGTACAA: CGATGGGGCATCGTACAAC
GCGATGTGGTGGCAATGTA: CGATGTGGTGGCAATGTAG
GCGCAAAAATCAACGGGAC: CGCAAAAATCAACGGGACC
GCGCAAATGGCTATCCCCT: CGCAAATGGCTATCCCCTG
GCGCAACTACTCCCCTCTC: CGCAACTACTCCCCTCTCA
GCGCAGTGAACTGAATCGT: CGCAGTGAACTGAATCGTC
GCGCCTCAGACTTCTCGTG: CGCCTCAGACTTCTCGTGC
GCGCGATGGGGCATCGTAC: CGCGATGGGGCATCGTACA
GCGCGCCTCAGACTTCTCG: CGCGCCTCAGACTTCTCGT
GCGGCCGTACAGAGAGCAG: CGGCCGTACAGAGAGCAGC
GCGGCGTCATCAGGACAGT: CGGCGTCATCAGGACAGTA
GCGGCTCCTTATGGACAGC: CGGCTCCTTATGGACAGCA
GCGGCTCTCAGCTACCCGA: CGGCTCTCAGCTACCCGAC
GCGGGAGTGACCGTGGCAT: CGGGAGTGACCGTGGCATC
GCGGGTATAGGGAGACTTA: CGGGTATAGGGAGACTTAG
GCGGTGCCGTCAGCATGCC: CGGTGCCGTCAGCATGCCG
GCGTAATGCGTTCAGACTT: CGTAATGCGTTCAGACTTC
GCGTAATTTTAGGGTTTAC: CGTAATTTTAGGGTTTACG
GCGTATTGAACCGTCGGGG: CGTATTGAACCGTCGGGGG
GCGTCAAGCGGGAGTGACC: CGTCAAGCGGGAGTGACCG
GCGTCATCAGGACAGTAAA: CGTCATCAGGACAGTAAAT
GCGTCGCGGCTCCTTATGG: CGTCGCGGCTCCTTATGGA
GCGTCTCGTCCTCTTCTGC: CGTCTCGTCCTCTTCTGCT
GCGTGTTGAGGGGGCCCCA: CGTGTTGAGGGGGCCCCAA
GCGTTCAGACTTCTCGTGC: CGTTCAGACTTCTCGTGCC
GCGTTGACGAACACATACT: CGTTGACGAACACATACTA
GCTAACCGGCGGTGCCGTC: CTAACCGGCGGTGCCGTCA
GCTAACCTTTGATTCTAGT: CTAACCTTTGATTCTAGTC
GCTACAGAATGAGTTTGAA: CTACAGAATGAGTTTGAAG
GCTACCCGACATTAAGACA: CTACCCGACATTAAGACAT
GCTACCCGTATCAAGTGAC: CTACCCGTATCAAGTGACC
GCTACCGCTATACTAAGCG: CTACCGCTATACTAAGCGT
GCTAGATGTATCTTACGTG: CTAGATGTATCTTACGTGC
GCTAGGAAATACCGCGTCT: CTAGGAAATACCGCGTCTC
GCTATACTAAGCGTTGACG: CTATACTAAGCGTTGACGA
GCTATCCCCTGCCACCAGT: CTATCCCCTGCCACCAGTG
GCTATGGCGTAATTTTAGG: CTATGGCGTAATTTTAGGG
GCTATTACTAATCAACTCA: CTATTACTAATCAACTCAT
GCTATTCACCTCCGCTCAG: CTATTCACCTCCGCTCAGA
GCTCAAGTAAAGCAGGGTT: CTCAAGTAAAGCAGGGTTA
GCTCAGAACGCAAGTACAA: CTCAGAACGCAAGTACAAC
GCTCCTTATGGACAGCATA: CTCCTTATGGACAGCATAC
GCTCGCTTCCGTCCTGCGT: CTCGCTTCCGTCCTGCGTA
GCTCTACCCCTTCTCAATT: CTCTACCCCTTCTCAATTA
GCTCTATCTAGAACCCACC: CTCTATCTAGAACCCACCG
GCTCTCAGCTACCCGACAT: CTCTCAGCTACCCGACATT
GCTCTCATGAGACGGTTCG: CTCTCATGAGACGGTTCGT
GCTCTCGCCCTATAACCCC: CTCTCGCCCTATAACCCCC
GCTCTTAAAACACCCCAGA: CTCTTAAAACACCCCAGAG
GCTGCGAACTCGCCATACT: CTGCGAACTCGCCATACTT
GCTGGAATGTTCTCTCAGA: CTGGAATGTTCTCTCAGAA
GCTGGCCACATTCAGCGTC: CTGGCCACATTCAGCGTCG
GCTGGGTTGCCTATGGCGA: CTGGGTTGCCTATGGCGAA
GCTGTCGGGCGCAAATGGC: CTGTCGGGCGCAAATGGCT
GCTTACAGGACATAGTATT: CTTACAGGACATAGTATTG
GCTTCCGTCCTGCGTATTG: CTTCCGTCCTGCGTATTGA
GCTTGAAGCAGGTACTGTG: CTTGAAGCAGGTACTGTGT
GCTTGACACAGAGATGGCT: CTTGACACAGAGATGGCTA
GCTTGCTCTACCCCTTCTC: CTTGCTCTACCCCTTCTCA
GCTTTATCCCGCCGCATTC: CTTTATCCCGCCGCATTCG
GCTTTTCGTGACTGTAGTA: CTTTTCGTGACTGTAGTAT
GGAAATACCGCGTCTCGTC: GAAATACCGCGTCTCGTCC
GGAACGTGGCTCTATCTAG: GAACGTGGCTCTATCTAGA
GGAACTAACGGCAAATTAA: GAACTAACGGCAAATTAAT
GGAAGGATCAGACTTCTCG: GAAGGATCAGACTTCTCGT
GGAATGATCGGTGATGGAG: GAATGATCGGTGATGGAGT
GGAATGTTCTCTCAGAACA: GAATGTTCTCTCAGAACAA
GGACAGCATACTATAGACG: GACAGCATACTATAGACGA
GGACAGTAAATCCTTGTTT: GACAGTAAATCCTTGTTTG
GGACATAGTATTGTTAGCA: GACATAGTATTGTTAGCAA
GGACATGGTTCTCGACCAT: GACATGGTTCTCGACCATC
GGACCGGCGGGTATAGGGA: GACCGGCGGGTATAGGGAG
GGACGCCAACCATGACCAC: GACGCCAACCATGACCACA
GGACGTAATAGGAATGATC: GACGTAATAGGAATGATCG
GGACGTCAACGTGCAAGTG: GACGTCAACGTGCAAGTGC
GGAGACTTAGACCCAGCAG: GAGACTTAGACCCAGCAGG
GGAGCGCGATGGGGCATCG: GAGCGCGATGGGGCATCGT
GGAGCTCTTAAAACACCCC: GAGCTCTTAAAACACCCCA
GGAGTAGTAGATACGCAGT: GAGTAGTAGATACGCAGTG
GGAGTGACCGTGGCATCCT: GAGTGACCGTGGCATCCTT
GGATATGGCTGGCCACATT: GATATGGCTGGCCACATTC
GGATCACTCCACAGTACCT: GATCACTCCACAGTACCTA
GGATCAGACTTCTCGTGCC: GATCAGACTTCTCGTGCCG
GGATCCGACCGTTGATCTC: GATCCGACCGTTGATCTCA
GGATCGATGACTGATATCT: GATCGATGACTGATATCTC
GGATCTTAACATGATCTCA: GATCTTAACATGATCTCAT
GGATTGTGCGAGCGTGTTG: GATTGTGCGAGCGTGTTGA
GGCAAATTAATGCCTGAGT: GCAAATTAATGCCTGAGTC
GGCAAGTCGTCGAGGGCCG: GCAAGTCGTCGAGGGCCGT
GGCAATGTAGCCGAATAGG: GCAATGTAGCCGAATAGGT
GGCAGCCCCGAAGGCTGGG: GCAGCCCCGAAGGCTGGGT
GGCATAATTGTCAGACTTC: GCATAATTGTCAGACTTCT
GGCATCCTTGCGCACCTTG: GCATCCTTGCGCACCTTGA
GGCATCGTACAACAGCATC: GCATCGTACAACAGCATCA
GGCATGATCCGAACCTTCT: GCATGATCCGAACCTTCTT
GGCATGCACGTGTTTTCAA: GCATGCACGTGTTTTCAAG
GGCCACATTCAGCGTCGCG: GCCACATTCAGCGTCGCGG
GGCCAGGACGTCAACGTGC: GCCAGGACGTCAACGTGCA
GGCCCCAATCCAGTCATTG: GCCCCAATCCAGTCATTGG
GGCCCCGGGCATGCACGTG: GCCCCGGGCATGCACGTGT
GGCCGAGGATTGTGCGAGC: GCCGAGGATTGTGCGAGCG
GGCCGGCCGAGGATTGTGC: GCCGGCCGAGGATTGTGCG
GGCCGTAATCATGCCTGGA: GCCGTAATCATGCCTGGAC
GGCCGTACAGAGAGCAGCC: GCCGTACAGAGAGCAGCCA
GGCCTAACGTCTTGAAGGA: GCCTAACGTCTTGAAGGAC
GGCGAATACTTCCATCCTC: GCGAATACTTCCATCCTCT
GGCGAATCCTGCCTGAGTC: GCGAATCCTGCCTGAGTCA
GGCGATGTGGTGGCAATGT: GCGATGTGGTGGCAATGTA
GGCGCAAATGGCTATCCCC: GCGCAAATGGCTATCCCCT
GGCGGCTCTCAGCTACCCG: GCGGCTCTCAGCTACCCGA
GGCGGGTATAGGGAGACTT: GCGGGTATAGGGAGACTTA
GGCGGTGCCGTCAGCATGC: GCGGTGCCGTCAGCATGCC
GGCGTAATTTTAGGGTTTA: GCGTAATTTTAGGGTTTAC
GGCGTCATCAGGACAGTAA: GCGTCATCAGGACAGTAAA
GGCTAACCTTTGATTCTAG: GCTAACCTTTGATTCTAGT
GGCTACCCGTATCAAGTGA: GCTACCCGTATCAAGTGAC
GGCTACCGCTATACTAAGC: GCTACCGCTATACTAAGCG
GGCTAGGAAATACCGCGTC: GCTAGGAAATACCGCGTCT
GGCTATCCCCTGCCACCAG: GCTATCCCCTGCCACCAGT
GGCTCAAGTAAAGCAGGGT: GCTCAAGTAAAGCAGGGTT
GGCTCCTTATGGACAGCAT: GCTCCTTATGGACAGCATA
GGCTCTATCTAGAACCCAC: GCTCTATCTAGAACCCACC
GGCTCTCAGCTACCCGACA: GCTCTCAGCTACCCGACAT
GGCTGCGAACTCGCCATAC: GCTGCGAACTCGCCATACT
GGCTGGCCACATTCAGCGT: GCTGGCCACATTCAGCGTC
GGCTGGGTTGCCTATGGCG: GCTGGGTTGCCTATGGCGA
GGCTTGACACAGAGATGGC: GCTTGACACAGAGATGGCT
GGCTTGCTCTACCCCTTCT: GCTTGCTCTACCCCTTCTC
GGGACCGGCGGGTATAGGG: GGACCGGCGGGTATAGGGA
GGGAGACTTAGACCCAGCA: GGAGACTTAGACCCAGCAG
GGGAGCTCTTAAAACACCC: GGAGCTCTTAAAACACCCC
GGGAGTGACCGTGGCATCC: GGAGTGACCGTGGCATCCT
GGGCATCGTACAACAGCAT: GGCATCGTACAACAGCATC
GGGCATGCACGTGTTTTCA: GGCATGCACGTGTTTTCAA
GGGCCAGGACGTCAACGTG: GGCCAGGACGTCAACGTGC
GGGCCCCAATCCAGTCATT: GGCCCCAATCCAGTCATTG
GGGCCCCGGGCATGCACGT: GGCCCCGGGCATGCACGTG
GGGCCGGCCGAGGATTGTG: GGCCGGCCGAGGATTGTGC
GGGCCGTAATCATGCCTGG: GGCCGTAATCATGCCTGGA
GGGCGAATCCTGCCTGAGT: GGCGAATCCTGCCTGAGTC
GGGCGATGTGGTGGCAATG: GGCGATGTGGTGGCAATGT
GGGCGCAAATGGCTATCCC: GGCGCAAATGGCTATCCCC
GGGCGGCTCTCAGCTACCC: GGCGGCTCTCAGCTACCCG
GGGGAGCTCTTAAAACACC: GGGAGCTCTTAAAACACCC
GGGGCATCGTACAACAGCA: GGGCATCGTACAACAGCAT
GGGGCCCCAATCCAGTCAT: GGGCCCCAATCCAGTCATT
GGGGCCGGCCGAGGATTGT: GGGCCGGCCGAGGATTGTG
GGGGGAGCTCTTAAAACAC: GGGGAGCTCTTAAAACACC
GGGGGCCCCAATCCAGTCA: GGGGCCCCAATCCAGTCAT
GGGTAGACATGTATTAGAC: GGTAGACATGTATTAGACC
GGGTATAGGGAGACTTAGA: GGTATAGGGAGACTTAGAC
GGGTGCCTTGCAGTGTGCG: GGTGCCTTGCAGTGTGCGC
GGGTTATAAACACATCCCG: GGTTATAAACACATCCCGT
GGGTTGCCTATGGCGAATA: GGTTGCCTATGGCGAATAC
GGGTTTACGGGCGAATCCT: GGTTTACGGGCGAATCCTG
GGTACTGTGTGTAGCTCGC: GTACTGTGTGTAGCTCGCT
GGTAGACAATACGGTCACT: GTAGACAATACGGTCACTT
GGTAGACATGTATTAGACC: GTAGACATGTATTAGACCT
GGTATAGGGAGACTTAGAC: GTATAGGGAGACTTAGACC
GGTATTTGACAATAGGTTG: GTATTTGACAATAGGTTGC
GGTCACTTATCTTCGTTCA: GTCACTTATCTTCGTTCAG
GGTCGTAAGCAGATATACC: GTCGTAAGCAGATATACCT
GGTCTAAAACATTTCGCTA: GTCTAAAACATTTCGCTAG
GGTGACACCTTCTGTATGG: GTGACACCTTCTGTATGGC
GGTGATGGAGTAGTAGATA: GTGATGGAGTAGTAGATAC
GGTGCCATTTCGATCCTAC: GTGCCATTTCGATCCTACC
GGTGCCGTCAGCATGCCGG: GTGCCGTCAGCATGCCGGG
GGTGCCTTGCAGTGTGCGC: GTGCCTTGCAGTGTGCGCA
GGTGCTGTCGGGCGCAAAT: GTGCTGTCGGGCGCAAATG
GGTGGCAATGTAGCCGAAT: GTGGCAATGTAGCCGAATA
GGTTATAAACACATCCCGT: GTTATAAACACATCCCGTC
GGTTCGTGGAGCGCGATGG: GTTCGTGGAGCGCGATGGG
GGTTCTCGACCATCGTACA: GTTCTCGACCATCGTACAA
GGTTGCCTATGGCGAATAC: GTTGCCTATGGCGAATACT
GGTTGCTGGAATGTTCTCT: GTTGCTGGAATGTTCTCTC
GGTTGCTTACAGGACATAG: GTTGCTTACAGGACATAGT
GGTTTAAGGGCCAGGACGT: GTTTAAGGGCCAGGACGTC
GGTTTACGGGCGAATCCTG: GTTTACGGGCGAATCCTGC
GTAAAAGCGAGATGTCTGC: TAAAAGCGAGATGTCTGCA
GTAAAGCAGGGTTATAAAC: TAAAGCAGGGTTATAAACA
GTAAAGGATCTTAACATGA: TAAAGGATCTTAACATGAT
GTAAATCCTTGTTTGAGGC: TAAATCCTTGTTTGAGGCA
GTAAGCAGATATACCTTCT: TAAGCAGATATACCTTCTC
GTAATAGGAATGATCGGTG: TAATAGGAATGATCGGTGA
GTAATCATGCCTGGACGCC: TAATCATGCCTGGACGCCA
GTAATGCGTTCAGACTTCT: TAATGCGTTCAGACTTCTC
GTAATTTTAGGGTTTACGG: TAATTTTAGGGTTTACGGG
GTACAACAGCATCAAGGCA: TACAACAGCATCAAGGCAT
GTACAACAGCATCACTATG: TACAACAGCATCACTATGC
GTACAACAGCATCAGCGTA: TACAACAGCATCAGCGTAA
GTACAACAGCATCATAATG: TACAACAGCATCATAATGG
GTACAACTCGAGTTGTAAA: TACAACTCGAGTTGTAAAG
GTACAGAGAGCAGCCAGTA: TACAGAGAGCAGCCAGTAG
GTACCACTAGCCCCTAACA: TACCACTAGCCCCTAACAG
GTACCTAGCTACAGAATGA: TACCTAGCTACAGAATGAG
GTACCTGAGCCTTGGGCGA: TACCTGAGCCTTGGGCGAT
GTACTGTGTGTAGCTCGCT: TACTGTGTGTAGCTCGCTT
GTAGACAATACGGTCACTT: TAGACAATACGGTCACTTA
GTAGACATGTATTAGACCT: TAGACATGTATTAGACCTA
GTAGATACGCAGTGTACCT: TAGATACGCAGTGTACCTG
GTAGCCGAATAGGTAGACA: TAGCCGAATAGGTAGACAA
GTAGCTCGCTTCCGTCCTG: TAGCTCGCTTCCGTCCTGC
GTAGTAGATACGCAGTGTA: TAGTAGATACGCAGTGTAC
GTAGTATTCTCTCTTCATC: TAGTATTCTCTCTTCATCG
GTAGTGCCAGGTCGTAAGC: TAGTGCCAGGTCGTAAGCA
GTATAGGGAGACTTAGACC: TATAGGGAGACTTAGACCC
GTATATCTCTCAAAATATC: TATATCTCTCAAAATATCT
GTATCAAGTGACCCTTCGT: TATCAAGTGACCCTTCGTG
GTATCATCCCCCAGCTATG: TATCATCCCCCAGCTATGG
GTATCTTACGTGCCCCCAA: TATCTTACGTGCCCCCAAC
GTATGGCTCAAGTAAAGCA: TATGGCTCAAGTAAAGCAG
GTATTAGACCTATGTAAAA: TATTAGACCTATGTAAAAG
GTATTCTCTCTTCATCGTA: TATTCTCTCTTCATCGTAC
GTATTGAACCGTCGGGGGA: TATTGAACCGTCGGGGGAG
GTATTGTTAGCAAACAGGC: TATTGTTAGCAAACAGGCC
GTATTTGACAATAGGTTGC: TATTTGACAATAGGTTGCT
GTCAAATATTGCGAATTGT: TCAAATATTGCGAATTGTT
GTCAACATAATGGACATGG: TCAACATAATGGACATGGT
GTCAACGTGCAAGTGCCGT: TCAACGTGCAAGTGCCGTG
GTCAAGCGGGAGTGACCGT: TCAAGCGGGAGTGACCGTG
GTCACTTATCTTCGTTCAG: TCACTTATCTTCGTTCAGC
GTCAGACTTCTCGTGCCGA: TCAGACTTCTCGTGCCGAC
GTCAGCATGCCGGGCCCCG: TCAGCATGCCGGGCCCCGG
GTCAGCGTCAAGCGGGAGT: TCAGCGTCAAGCGGGAGTG
GTCATCAGGACAGTAAATC: TCATCAGGACAGTAAATCC
GTCATTGGGTGCCTTGCAG: TCATTGGGTGCCTTGCAGT
GTCCGTGTTTGACATTCAC: TCCGTGTTTGACATTCACG
GTCCTCAGCTTTATCCCGC: TCCTCAGCTTTATCCCGCC
GTCCTCTTCTGCTCTCATG: TCCTCTTCTGCTCTCATGA
GTCCTGCGTATTGAACCGT: TCCTGCGTATTGAACCGTC
GTCGAATCGCAGGTGCTGT: TCGAATCGCAGGTGCTGTC
GTCGAGAAGAAATTGCAAG: TCGAGAAGAAATTGCAAGG
GTCGAGGGCCGTAATCATG: TCGAGGGCCGTAATCATGC
GTCGCGGCTCCTTATGGAC: TCGCGGCTCCTTATGGACA
GTCGGATCACTCCACAGTA: TCGGATCACTCCACAGTAC
GTCGGATCGATGACTGATA: TCGGATCGATGACTGATAT
GTCGGCAGCCCCGAAGGCT: TCGGCAGCCCCGAAGGCTG
GTCGGGCGCAAATGGCTAT: TCGGGCGCAAATGGCTATC
GTCGGGGGAGCTCTTAAAA: TCGGGGGAGCTCTTAAAAC
GTCGGTTGCTGGAATGTTC: TCGGTTGCTGGAATGTTCT
GTCGTAAGCAGATATACCT: TCGTAAGCAGATATACCTT
GTCGTCGAGGGCCGTAATC: TCGTCGAGGGCCGTAATCA
GTCGTCTAGACGAGTACCA: TCGTCTAGACGAGTACCAC
GTCTAAAACATTTCGCTAG: TCTAAAACATTTCGCTAGA
GTCTAGACGAGTACCACTA: TCTAGACGAGTACCACTAG
GTCTCGTCCTCTTCTGCTC: TCTCGTCCTCTTCTGCTCT
GTCTGCAACACGTTGTCGG: TCTGCAACACGTTGTCGGT
GTCTTGAAGGACGTAATAG: TCTTGAAGGACGTAATAGG
GTGAACTGAATCGTCGAAT: TGAACTGAATCGTCGAATC
GTGACACCTTCTGTATGGC: TGACACCTTCTGTATGGCT
GTGACCCTTCGTGGTGCCA: TGACCCTTCGTGGTGCCAT
GTGACCGTGGCATCCTTGC: TGACCGTGGCATCCTTGCG
GTGACTCTGCTTTTCGTGA: TGACTCTGCTTTTCGTGAC
GTGACTGTAGTATTCTCTC: TGACTGTAGTATTCTCTCT
GTGATCGTTGCTCTCGCCC: TGATCGTTGCTCTCGCCCT
GTGATGGAGTAGTAGATAC: TGATGGAGTAGTAGATACG
GTGCAAGTGCCGTGCTTGA: TGCAAGTGCCGTGCTTGAA
GTGCCAGGTCGTAAGCAGA: TGCCAGGTCGTAAGCAGAT
GTGCCATTTCGATCCTACC: TGCCATTTCGATCCTACCG
GTGCCCCCAACATTCTACT: TGCCCCCAACATTCTACTG
GTGCCGACATATTTTTAAT: TGCCGACATATTTTTAATT
GTGCCGACTGACTATTACA: TGCCGACTGACTATTACAT
GTGCCGACTTGAAGGAACG: TGCCGACTTGAAGGAACGT
GTGCCGACTTTTGCATGAT: TGCCGACTTTTGCATGATT
GTGCCGTCAGCATGCCGGG: TGCCGTCAGCATGCCGGGC
GTGCCGTGCTTGAAGCAGG: TGCCGTGCTTGAAGCAGGT
GTGCCTTGCAGTGTGCGCA: TGCCTTGCAGTGTGCGCAA
GTGCGAGCGTGTTGAGGGG: TGCGAGCGTGTTGAGGGGG
GTGCGCAAAAATCAACGGG: TGCGCAAAAATCAACGGGA
GTGCTGTCGGGCGCAAATG: TGCTGTCGGGCGCAAATGG
GTGCTTGAAGCAGGTACTG: TGCTTGAAGCAGGTACTGT
GTGGAGCGCGATGGGGCAT: TGGAGCGCGATGGGGCATC
GTGGATATGGCTGGCCACA: TGGATATGGCTGGCCACAT
GTGGCAATGTAGCCGAATA: TGGCAATGTAGCCGAATAG
GTGGCATCCTTGCGCACCT: TGGCATCCTTGCGCACCTT
GTGGCTAGGAAATACCGCG: TGGCTAGGAAATACCGCGT
GTGGCTCTATCTAGAACCC: TGGCTCTATCTAGAACCCA
GTGGCTGCGAACTCGCCAT: TGGCTGCGAACTCGCCATA
GTGGTGCCATTTCGATCCT: TGGTGCCATTTCGATCCTA
GTGGTGGCAATGTAGCCGA: TGGTGGCAATGTAGCCGAA
GTGTACCTGAGCCTTGGGC: TGTACCTGAGCCTTGGGCG
GTGTAGCTCGCTTCCGTCC: TGTAGCTCGCTTCCGTCCT
GTGTGCGCAAAAATCAACG: TGTGCGCAAAAATCAACGG
GTGTGTAGCTCGCTTCCGT: TGTGTAGCTCGCTTCCGTC
GTGTTGAGGGGGCCCCAAT: TGTTGAGGGGGCCCCAATC
GTGTTTGACATTCACGTTC: TGTTTGACATTCACGTTCC
GTGTTTTCAAGTCGGCAGC: TGTTTTCAAGTCGGCAGCC
GTTAGCAAACAGGCCTAAC: TTAGCAAACAGGCCTAACG
GTTATAAACACATCCCGTC: TTATAAACACATCCCGTCG
GTTATGATTTGTGACTCTG: TTATGATTTGTGACTCTGC
GTTCAGACTTCTCGTGCCG: TTCAGACTTCTCGTGCCGA
GTTCAGCTATTCACCTCCG: TTCAGCTATTCACCTCCGC
GTTCCTAGTCAACATAATG: TTCCTAGTCAACATAATGG
GTTCGTGGAGCGCGATGGG: TTCGTGGAGCGCGATGGGG
GTTCTCGACCATCGTACAA: TTCTCGACCATCGTACAAC
GTTCTCTCAGAACAACGGC: TTCTCTCAGAACAACGGCA
GTTGACGAACACATACTAC: TTGACGAACACATACTACG
GTTGAGGGGGCCCCAATCC: TTGAGGGGGCCCCAATCCA
GTTGATCTCACGACCCATT: TTGATCTCACGACCCATTT
GTTGCCTATGGCGAATACT: TTGCCTATGGCGAATACTT
GTTGCTCTCGCCCTATAAC: TTGCTCTCGCCCTATAACC
GTTGCTGGAATGTTCTCTC: TTGCTGGAATGTTCTCTCA
GTTGCTTACAGGACATAGT: TTGCTTACAGGACATAGTA
GTTGTAAAGGATCTTAACA: TTGTAAAGGATCTTAACAT
GTTGTCGGTTGCTGGAATG: TTGTCGGTTGCTGGAATGT
GTTTAAGGGCCAGGACGTC: TTTAAGGGCCAGGACGTCA
GTTTAATCCCTAGATGAGT: TTTAATCCCTAGATGAGTT
GTTTACGGGCGAATCCTGC: TTTACGGGCGAATCCTGCC
GTTTGAAGAAGGTTTAAGG: TTTGAAGAAGGTTTAAGGG
GTTTGACATTCACGTTCCT: TTTGACATTCACGTTCCTA
GTTTGAGGCATGATCCGAA: TTTGAGGCATGATCCGAAC
GTTTTCAAGTCGGCAGCCC: TTTTCAAGTCGGCAGCCCC
TAAAACACCCCAGAGCACA: AAAACACCCCAGAGCACAC
TAAAACATTTCGCTAGATG: AAAACATTTCGCTAGATGT
TAAAAGCGAGATGTCTGCA: AAAAGCGAGATGTCTGCAA
TAAACACATCCCGTCGAGA: AAACACATCCCGTCGAGAA
TAAAGCAGGGTTATAAACA: AAAGCAGGGTTATAAACAC
TAAAGGATCTTAACATGAT: AAAGGATCTTAACATGATC
TAAATCCTTGTTTGAGGCA: AAATCCTTGTTTGAGGCAT
TAACAGGTATTTGACAATA: AACAGGTATTTGACAATAG
TAACATGATCTCATGAGTG: AACATGATCTCATGAGTGG
TAACCCCCATATCAGGTCT: AACCCCCATATCAGGTCTA
TAACCGGCGGTGCCGTCAG: AACCGGCGGTGCCGTCAGC
TAACCTTTGATTCTAGTCC: AACCTTTGATTCTAGTCCT
TAACGGCAAATTAATGCCT: AACGGCAAATTAATGCCTG
TAACGTCTTGAAGGACGTA: AACGTCTTGAAGGACGTAA
TAAGACATCGTACAACAGC: AAGACATCGTACAACAGCA
TAAGCAGATATACCTTCTC: AAGCAGATATACCTTCTCA
TAAGCGTTGACGAACACAT: AAGCGTTGACGAACACATA
TAAGGGCCAGGACGTCAAC: AAGGGCCAGGACGTCAACG
TAATAGGAATGATCGGTGA: AATAGGAATGATCGGTGAT
TAATCAACTCATTTCCGTG: AATCAACTCATTTCCGTGG
TAATCATGCCTGGACGCCA: AATCATGCCTGGACGCCAA
TAATCCCTAGATGAGTTAT: AATCCCTAGATGAGTTATG
TAATGCCTGAGTCGGATCA: AATGCCTGAGTCGGATCAC
TAATGCGTTCAGACTTCTC: AATGCGTTCAGACTTCTCG
TAATGGAAGGATCAGACTT: AATGGAAGGATCAGACTTC
TAATGGACATGGTTCTCGA: AATGGACATGGTTCTCGAC
TAATTCCAGTCCGTGTTTG: AATTCCAGTCCGTGTTTGA
TAATTGTCAGACTTCTCGT: AATTGTCAGACTTCTCGTG
TAATTTTAGGGTTTACGGG: AATTTTAGGGTTTACGGGC
TACAACAGCATCAAGGCAT: ACAACAGCATCAAGGCATA
TACAACAGCATCACTATGC: ACAACAGCATCACTATGCG
TACAACAGCATCAGCGTAA: ACAACAGCATCAGCGTAAT
TACAACAGCATCATAATGG: ACAACAGCATCATAATGGA
TACAACTCGAGTTGTAAAG: ACAACTCGAGTTGTAAAGG
TACAGAATGAGTTTGAAGA: ACAGAATGAGTTTGAAGAA
TACAGAGAGCAGCCAGTAG: ACAGAGAGCAGCCAGTAGT
TACAGGACATAGTATTGTT: ACAGGACATAGTATTGTTA
TACATATGCGGCGTCATCA: ACATATGCGGCGTCATCAG
TACCACTAGCCCCTAACAG: ACCACTAGCCCCTAACAGG
TACCCCTTCTCAATTAGCA: ACCCCTTCTCAATTAGCAA
TACCCGACATTAAGACATC: ACCCGACATTAAGACATCG
TACCCGTATCAAGTGACCC: ACCCGTATCAAGTGACCCT
TACCGCGTCTCGTCCTCTT: ACCGCGTCTCGTCCTCTTC
TACCGCTATACTAAGCGTT: ACCGCTATACTAAGCGTTG
TACCGTCGTCTAGACGAGT: ACCGTCGTCTAGACGAGTA
TACCTAGCTACAGAATGAG: ACCTAGCTACAGAATGAGT
TACCTGAGCCTTGGGCGAT: ACCTGAGCCTTGGGCGATG
TACCTTCTCACCAAGAATG: ACCTTCTCACCAAGAATGC
TACGCAGTGTACCTGAGCC: ACGCAGTGTACCTGAGCCT
TACGGGCGAATCCTGCCTG: ACGGGCGAATCCTGCCTGA
TACGGTCACTTATCTTCGT: ACGGTCACTTATCTTCGTT
TACGTCGGATCGATGACTG: ACGTCGGATCGATGACTGA
TACGTGCCCCCAACATTCT: ACGTGCCCCCAACATTCTA
TACTAAGCGTTGACGAACA: ACTAAGCGTTGACGAACAC
TACTAATCAACTCATTTCC: ACTAATCAACTCATTTCCG
TACTACGTCGGATCGATGA: ACTACGTCGGATCGATGAC
TACTATAGACGAATTCCCG: ACTATAGACGAATTCCCGA
TACTCCCCTCTCAGGGTAG: ACTCCCCTCTCAGGGTAGA
TACTGTATATCTCTCAAAA: ACTGTATATCTCTCAAAAT
TACTGTGTGTAGCTCGCTT: ACTGTGTGTAGCTCGCTTC
TACTTCCATCCTCTTCTGC: ACTTCCATCCTCTTCTGCA
TACTTGGGGCCGGCCGAGG: ACTTGGGGCCGGCCGAGGA
TAGAACCCACCGGCTACCG: AGAACCCACCGGCTACCGC
TAGACAATACGGTCACTTA: AGACAATACGGTCACTTAT
TAGACATGTATTAGACCTA: AGACATGTATTAGACCTAT
TAGACCCAGCAGGATCCGA: AGACCCAGCAGGATCCGAC
TAGACCTATGTAAAAGCGA: AGACCTATGTAAAAGCGAG
TAGACGAATTCCCGACACA: AGACGAATTCCCGACACAA
TAGACGAGTACCACTAGCC: AGACGAGTACCACTAGCCC
TAGATACGCAGTGTACCTG: AGATACGCAGTGTACCTGA
TAGATGAGTTATGATTTGT: AGATGAGTTATGATTTGTG
TAGATGTATCTTACGTGCC: AGATGTATCTTACGTGCCC
TAGCAAACAGGCCTAACGT: AGCAAACAGGCCTAACGTC
TAGCAATCACTGAAGCTAT: AGCAATCACTGAAGCTATT
TAGCCCCTAACAGGTATTT: AGCCCCTAACAGGTATTTG
TAGCCGAATAGGTAGACAA: AGCCGAATAGGTAGACAAT
TAGCGCAACTACTCCCCTC: AGCGCAACTACTCCCCTCT
TAGCGCAGTGAACTGAATC: AGCGCAGTGAACTGAATCG
TAGCTACAGAATGAGTTTG: AGCTACAGAATGAGTTTGA
TAGCTCGCTTCCGTCCTGC: AGCTCGCTTCCGTCCTGCG
TAGGAAATACCGCGTCTCG: AGGAAATACCGCGTCTCGT
TAGGAATGATCGGTGATGG: AGGAATGATCGGTGATGGA
TAGGCTACCCGTATCAAGT: AGGCTACCCGTATCAAGTG
TAGGCTTGACACAGAGATG: AGGCTTGACACAGAGATGG
TAGGGAGACTTAGACCCAG: AGGGAGACTTAGACCCAGC
TAGGGTTTACGGGCGAATC: AGGGTTTACGGGCGAATCC
TAGGTAGACAATACGGTCA: AGGTAGACAATACGGTCAC
TAGGTTGCTTACAGGACAT: AGGTTGCTTACAGGACATA
TAGTAGATACGCAGTGTAC: AGTAGATACGCAGTGTACC
TAGTATTCTCTCTTCATCG: AGTATTCTCTCTTCATCGT
TAGTATTGTTAGCAAACAG: AGTATTGTTAGCAAACAGG
TAGTCAACATAATGGACAT: AGTCAACATAATGGACATG
TAGTCCTCAGCTTTATCCC: AGTCCTCAGCTTTATCCCG
TAGTGCCAGGTCGTAAGCA: AGTGCCAGGTCGTAAGCAG
TATAAACACATCCCGTCGA: ATAAACACATCCCGTCGAG
TATAACCCCCATATCAGGT: ATAACCCCCATATCAGGTC
TATACCTTCTCACCAAGAA: ATACCTTCTCACCAAGAAT
TATACTAAGCGTTGACGAA: ATACTAAGCGTTGACGAAC
TATAGACGAATTCCCGACA: ATAGACGAATTCCCGACAC
TATAGGGAGACTTAGACCC: ATAGGGAGACTTAGACCCA
TATATCTCTCAAAATATCT: ATATCTCTCAAAATATCTC
TATCAAGTGACCCTTCGTG: ATCAAGTGACCCTTCGTGG
TATCAGGTCTAAAACATTT: ATCAGGTCTAAAACATTTC
TATCATCCCCCAGCTATGG: ATCATCCCCCAGCTATGGC
TATCCCCTGCCACCAGTGA: ATCCCCTGCCACCAGTGAT
TATCCCGCCGCATTCGCGG: ATCCCGCCGCATTCGCGGC
TATCTAGAACCCACCGGCT: ATCTAGAACCCACCGGCTA
TATCTCCGAAGGTGACACC: ATCTCCGAAGGTGACACCT
TATCTCTCAAAATATCTCT: ATCTCTCAAAATATCTCTC
TATCTCTCCTTCGATTGGG: ATCTCTCCTTCGATTGGGC
TATCTTACGTGCCCCCAAC: ATCTTACGTGCCCCCAACA
TATCTTCGTTCAGCTATTC: ATCTTCGTTCAGCTATTCA
TATGATTTGTGACTCTGCT: ATGATTTGTGACTCTGCTT
TATGCGCGCCTCAGACTTC: ATGCGCGCCTCAGACTTCT
TATGCGGCGTCATCAGGAC: ATGCGGCGTCATCAGGACA
TATGGACAGCATACTATAG: ATGGACAGCATACTATAGA
TATGGCGAATACTTCCATC: ATGGCGAATACTTCCATCC
TATGGCGTAATTTTAGGGT: ATGGCGTAATTTTAGGGTT
TATGGCTCAAGTAAAGCAG: ATGGCTCAAGTAAAGCAGG
TATGGCTGGCCACATTCAG: ATGGCTGGCCACATTCAGC
TATGTAAAAGCGAGATGTC: ATGTAAAAGCGAGATGTCT
TATTACATATGCGGCGTCA: ATTACATATGCGGCGTCAT
TATTACTAATCAACTCATT: ATTACTAATCAACTCATTT
TATTAGACCTATGTAAAAG: ATTAGACCTATGTAAAAGC
TATTCACCTCCGCTCAGAA: ATTCACCTCCGCTCAGAAC
TATTCTCTCTTCATCGTAC: ATTCTCTCTTCATCGTACA
TATTGAACCGTCGGGGGAG: ATTGAACCGTCGGGGGAGC
TATTGCGAATTGTTTAATC: ATTGCGAATTGTTTAATCC
TATTGTTAGCAAACAGGCC: ATTGTTAGCAAACAGGCCT
TATTTGACAATAGGTTGCT: ATTTGACAATAGGTTGCTT
TATTTTTAATTCCAGTCCG: ATTTTTAATTCCAGTCCGT
TCAAAATATCTCTCCTTCG: CAAAATATCTCTCCTTCGA
TCAAATATTGCGAATTGTT: CAAATATTGCGAATTGTTT
TCAACATAATGGACATGGT: CAACATAATGGACATGGTT
TCAACGGGACCGGCGGGTA: CAACGGGACCGGCGGGTAT
TCAACGTGCAAGTGCCGTG: CAACGTGCAAGTGCCGTGC
TCAACTCATTTCCGTGGCT: CAACTCATTTCCGTGGCTG
TCAAGCGGGAGTGACCGTG: CAAGCGGGAGTGACCGTGG
TCAAGGCATAATTGTCAGA: CAAGGCATAATTGTCAGAC
TCAAGTAAAGCAGGGTTAT: CAAGTAAAGCAGGGTTATA
TCAAGTCGGCAGCCCCGAA: CAAGTCGGCAGCCCCGAAG
TCAAGTGACCCTTCGTGGT: CAAGTGACCCTTCGTGGTG
TCAATAGCGCAGTGAACTG: CAATAGCGCAGTGAACTGA
TCAATTAGCAATCACTGAA: CAATTAGCAATCACTGAAG
TCACCAAGAATGCTAACCG: CACCAAGAATGCTAACCGG
TCACCTCCGCTCAGAACGC: CACCTCCGCTCAGAACGCA
TCACGACCCATTTTCCTCC: CACGACCCATTTTCCTCCG
TCACGTTCCTAGTCAACAT: CACGTTCCTAGTCAACATA
TCACTATGCGCGCCTCAGA: CACTATGCGCGCCTCAGAC
TCACTCCACAGTACCTAGC: CACTCCACAGTACCTAGCT
TCACTGAAGCTATTACTAA: CACTGAAGCTATTACTAAT
TCACTTATCTTCGTTCAGC: CACTTATCTTCGTTCAGCT
TCAGAACAACGGCAAGTCG: CAGAACAACGGCAAGTCGT
TCAGAACGCAAGTACAACT: CAGAACGCAAGTACAACTC
TCAGACTTCTCGTGCCGAC: CAGACTTCTCGTGCCGACT CAGACTTCTCGTGCCGACT CAGACTTCTCGTGCCGACT CAGACTTCTCGTGCCGACA
TCAGCATGCCGGGCCCCGG: CAGCATGCCGGGCCCCGGG
TCAGCGTAATGCGTTCAGA: CAGCGTAATGCGTTCAGAC
TCAGCGTCAAGCGGGAGTG: CAGCGTCAAGCGGGAGTGA
TCAGCGTCGCGGCTCCTTA: CAGCGTCGCGGCTCCTTAT
TCAGCTACCCGACATTAAG: CAGCTACCCGACATTAAGA
TCAGCTATTCACCTCCGCT: CAGCTATTCACCTCCGCTC
TCAGCTTTATCCCGCCGCA: CAGCTTTATCCCGCCGCAT
TCAGGACAGTAAATCCTTG: CAGGACAGTAAATCCTTGT
TCAGGGTAGACATGTATTA: CAGGGTAGACATGTATTAG
TCAGGTCTAAAACATTTCG: CAGGTCTAAAACATTTCGC
TCATAATGGAAGGATCAGA: CATAATGGAAGGATCAGAC
TCATCAGGACAGTAAATCC: CATCAGGACAGTAAATCCT
TCATCCCCCAGCTATGGCG: CATCCCCCAGCTATGGCGT
TCATCGTACAACAGCATCA: CATCGTACAACAGCATCAT
TCATGAGACGGTTCGTGGA: CATGAGACGGTTCGTGGAG
TCATGAGTGGATATGGCTG: CATGAGTGGATATGGCTGG
TCATGCCTGGACGCCAACC: CATGCCTGGACGCCAACCA
TCATTGGGTGCCTTGCAGT: CATTGGGTGCCTTGCAGTG
TCATTTCCGTGGCTGCGAA: CATTTCCGTGGCTGCGAAC
TCCACAGTACCTAGCTACA: CCACAGTACCTAGCTACAG
TCCAGTCATTGGGTGCCTT: CCAGTCATTGGGTGCCTTG
TCCAGTCCGTGTTTGACAT: CCAGTCCGTGTTTGACATT
TCCATCCTCTTCTGCAACT: CCATCCTCTTCTGCAACTA
TCCCCCAGCTATGGCGTAA: CCCCCAGCTATGGCGTAAT
TCCCCTCTCAGGGTAGACA: CCCCTCTCAGGGTAGACAT
TCCCCTGCCACCAGTGATC: CCCCTGCCACCAGTGATCG
TCCCGACACAAGATCCTGT: CCCGACACAAGATCCTGTG
TCCCGCCGCATTCGCGGCC: CCCGCCGCATTCGCGGCCG
TCCCGTCGAGAAGAAATTG: CCCGTCGAGAAGAAATTGC
TCCCTAGATGAGTTATGAT: CCCTAGATGAGTTATGATT
TCCGAACCTTCTTAGGCTA: CCGAACCTTCTTAGGCTAC
TCCGAAGGTGACACCTTCT: CCGAAGGTGACACCTTCTG
TCCGACCGTTGATCTCACG: CCGACCGTTGATCTCACGA
TCCGCTCAGAACGCAAGTA: CCGCTCAGAACGCAAGTAC
TCCGGAACTAACGGCAAAT: CCGGAACTAACGGCAAATT
TCCGTCCTGCGTATTGAAC: CCGTCCTGCGTATTGAACC
TCCGTGGCTGCGAACTCGC: CCGTGGCTGCGAACTCGCC
TCCGTGTTTGACATTCACG: CCGTGTTTGACATTCACGT
TCCTACCGTCGTCTAGACG: CCTACCGTCGTCTAGACGA
TCCTAGTCAACATAATGGA: CCTAGTCAACATAATGGAC
TCCTCAGCTTTATCCCGCC: CCTCAGCTTTATCCCGCCG
TCCTCCGGAACTAACGGCA: CCTCCGGAACTAACGGCAA
TCCTCTTCTGCAACTAGCG: CCTCTTCTGCAACTAGCGC
TCCTCTTCTGCTCTCATGA: CCTCTTCTGCTCTCATGAG
TCCTGCCTGAGTCAGCGTC: CCTGCCTGAGTCAGCGTCA
TCCTGCGTATTGAACCGTC: CCTGCGTATTGAACCGTCG
TCCTGTGGCTAGGAAATAC: CCTGTGGCTAGGAAATACC
TCCTTATGGACAGCATACT: CCTTATGGACAGCATACTA
TCCTTCGATTGGGCGGCTC: CCTTCGATTGGGCGGCTCT
TCCTTGTTTGAGGCATGAT: CCTTGTTTGAGGCATGATC
TCGAATCGCAGGTGCTGTC: CGAATCGCAGGTGCTGTCG
TCGACCATCGTACAACAGC: CGACCATCGTACAACAGCA
TCGAGAAGAAATTGCAAGG: CGAGAAGAAATTGCAAGGC
TCGAGGGCCGTAATCATGC: CGAGGGCCGTAATCATGCC
TCGAGTTGTAAAGGATCTT: CGAGTTGTAAAGGATCTTA
TCGATCCTACCGTCGTCTA: CGATCCTACCGTCGTCTAG
TCGATGACTGATATCTCCG: CGATGACTGATATCTCCGA
TCGATTGGGCGGCTCTCAG: CGATTGGGCGGCTCTCAGC
TCGCAGGTGCTGTCGGGCG: CGCAGGTGCTGTCGGGCGC
TCGCCATACTTGGGGCCGG: CGCCATACTTGGGGCCGGC
TCGCCCTATAACCCCCATA: CGCCCTATAACCCCCATAT
TCGCGGCCGTACAGAGAGC: CGCGGCCGTACAGAGAGCA
TCGCGGCTCCTTATGGACA: CGCGGCTCCTTATGGACAG
TCGCTAGATGTATCTTACG: CGCTAGATGTATCTTACGT
TCGCTTCCGTCCTGCGTAT: CGCTTCCGTCCTGCGTATT
TCGGATCACTCCACAGTAC: CGGATCACTCCACAGTACC
TCGGATCGATGACTGATAT: CGGATCGATGACTGATATC
TCGGCAGCCCCGAAGGCTG: CGGCAGCCCCGAAGGCTGG
TCGGGCGCAAATGGCTATC: CGGGCGCAAATGGCTATCC
TCGGGGGAGCTCTTAAAAC: CGGGGGAGCTCTTAAAACA
TCGGTGATGGAGTAGTAGA: CGGTGATGGAGTAGTAGAT
TCGGTTGCTGGAATGTTCT: CGGTTGCTGGAATGTTCTC
TCGTAAGCAGATATACCTT: CGTAAGCAGATATACCTTC
TCGTACAACAGCATCAAGG: CGTACAACAGCATCAAGGC
TCGTACAACAGCATCACTA: CGTACAACAGCATCACTAT
TCGTACAACAGCATCAGCG: CGTACAACAGCATCAGCGT
TCGTACAACAGCATCATAA: CGTACAACAGCATCATAAT
TCGTCCTCTTCTGCTCTCA: CGTCCTCTTCTGCTCTCAT
TCGTCGAATCGCAGGTGCT: CGTCGAATCGCAGGTGCTG
TCGTCGAGGGCCGTAATCA: CGTCGAGGGCCGTAATCAT
TCGTCTAGACGAGTACCAC: CGTCTAGACGAGTACCACT
TCGTGACTGTAGTATTCTC: CGTGACTGTAGTATTCTCT
TCGTGCCGACATATTTTTA: CGTGCCGACATATTTTTAA
TCGTGCCGACTGACTATTA: CGTGCCGACTGACTATTAC
TCGTGCCGACTTGAAGGAA: CGTGCCGACTTGAAGGAAC
TCGTGCCGACTTTTGCATG: CGTGCCGACTTTTGCATGA
TCGTGGAGCGCGATGGGGC: CGTGGAGCGCGATGGGGCA
TCGTGGTGCCATTTCGATC: CGTGGTGCCATTTCGATCC
TCGTTCAGCTATTCACCTC: CGTTCAGCTATTCACCTCC
TCGTTGCTCTCGCCCTATA: CGTTGCTCTCGCCCTATAA
TCTAAAACATTTCGCTAGA: CTAAAACATTTCGCTAGAT
TCTACCCCTTCTCAATTAG: CTACCCCTTCTCAATTAGC
TCTACTGTATATCTCTCAA: CTACTGTATATCTCTCAAA
TCTAGAACCCACCGGCTAC: CTAGAACCCACCGGCTACC
TCTAGACGAGTACCACTAG: CTAGACGAGTACCACTAGC
TCTAGTCCTCAGCTTTATC: CTAGTCCTCAGCTTTATCC
TCTATCTAGAACCCACCGG: CTATCTAGAACCCACCGGC
TCTCAAAATATCTCTCCTT: CTCAAAATATCTCTCCTTC
TCTCAATTAGCAATCACTG: CTCAATTAGCAATCACTGA
TCTCACCAAGAATGCTAAC: CTCACCAAGAATGCTAACC
TCTCACGACCCATTTTCCT: CTCACGACCCATTTTCCTC
TCTCAGAACAACGGCAAGT: CTCAGAACAACGGCAAGTC
TCTCAGCTACCCGACATTA: CTCAGCTACCCGACATTAA
TCTCAGGGTAGACATGTAT: CTCAGGGTAGACATGTATT
TCTCATGAGACGGTTCGTG: CTCATGAGACGGTTCGTGG
TCTCATGAGTGGATATGGC: CTCATGAGTGGATATGGCT
TCTCCGAAGGTGACACCTT: CTCCGAAGGTGACACCTTC
TCTCCTTCGATTGGGCGGC: CTCCTTCGATTGGGCGGCT
TCTCGACCATCGTACAACA: CTCGACCATCGTACAACAG
TCTCGCCCTATAACCCCCA: CTCGCCCTATAACCCCCAT
TCTCGTCCTCTTCTGCTCT: CTCGTCCTCTTCTGCTCTC
TCTCGTGCCGACATATTTT: CTCGTGCCGACATATTTTT
TCTCGTGCCGACTGACTAT: CTCGTGCCGACTGACTATT
TCTCGTGCCGACTTGAAGG: CTCGTGCCGACTTGAAGGA
TCTCGTGCCGACTTTTGCA: CTCGTGCCGACTTTTGCAT
TCTCTCAAAATATCTCTCC: CTCTCAAAATATCTCTCCT
TCTCTCAGAACAACGGCAA: CTCTCAGAACAACGGCAAG
TCTCTCCTTCGATTGGGCG: CTCTCCTTCGATTGGGCGG
TCTCTCTTCATCGTACAAC: CTCTCTTCATCGTACAACA
TCTCTTCATCGTACAACAG: CTCTTCATCGTACAACAGC
TCTGCAACACGTTGTCGGT: CTGCAACACGTTGTCGGTT
TCTGCAACTAGCGCAACTA: CTGCAACTAGCGCAACTAC
TCTGCTCTCATGAGACGGT: CTGCTCTCATGAGACGGTT
TCTGCTTTTCGTGACTGTA: CTGCTTTTCGTGACTGTAG
TCTGTATGGCTCAAGTAAA: CTGTATGGCTCAAGTAAAG
TCTTAAAACACCCCAGAGC: CTTAAAACACCCCAGAGCA
TCTTAACATGATCTCATGA: CTTAACATGATCTCATGAG
TCTTACGTGCCCCCAACAT: CTTACGTGCCCCCAACATT
TCTTAGGCTACCCGTATCA: CTTAGGCTACCCGTATCAA
TCTTCATCGTACAACAGCA: CTTCATCGTACAACAGCAT
TCTTCGTTCAGCTATTCAC: CTTCGTTCAGCTATTCACC
TCTTCTGCAACTAGCGCAA: CTTCTGCAACTAGCGCAAC
TCTTCTGCTCTCATGAGAC: CTTCTGCTCTCATGAGACG
TCTTGAAGGACGTAATAGG: CTTGAAGGACGTAATAGGA
TGAACCGTCGGGGGAGCTC: GAACCGTCGGGGGAGCTCT
TGAACTGAATCGTCGAATC: GAACTGAATCGTCGAATCG
TGAAGAAGGTTTAAGGGCC: GAAGAAGGTTTAAGGGCCA
TGAAGCAGGTACTGTGTGT: GAAGCAGGTACTGTGTGTA
TGAAGCTATTACTAATCAA: GAAGCTATTACTAATCAAC
TGAAGGAACGTGGCTCTAT: GAAGGAACGTGGCTCTATC
TGAAGGACGTAATAGGAAT: GAAGGACGTAATAGGAATG
TGAATCGTCGAATCGCAGG: GAATCGTCGAATCGCAGGT
TGACAATAGGTTGCTTACA: GACAATAGGTTGCTTACAG
TGACACAGAGATGGCTAAC: GACACAGAGATGGCTAACC
TGACACCTTCTGTATGGCT: GACACCTTCTGTATGGCTC
TGACATTCACGTTCCTAGT: GACATTCACGTTCCTAGTC
TGACCACATCAATAGCGCA: GACCACATCAATAGCGCAG
TGACCCTTCGTGGTGCCAT: GACCCTTCGTGGTGCCATT
TGACCGTGGCATCCTTGCG: GACCGTGGCATCCTTGCGC
TGACGAACACATACTACGT: GACGAACACATACTACGTC
TGACTATTACATATGCGGC: GACTATTACATATGCGGCG
TGACTCTGCTTTTCGTGAC: GACTCTGCTTTTCGTGACT
TGACTGATATCTCCGAAGG: GACTGATATCTCCGAAGGT
TGACTGTAGTATTCTCTCT: GACTGTAGTATTCTCTCTT
TGAGACGGTTCGTGGAGCG: GAGACGGTTCGTGGAGCGC
TGAGCCTTGGGCGATGTGG: GAGCCTTGGGCGATGTGGT
TGAGGCATGATCCGAACCT: GAGGCATGATCCGAACCTT
TGAGGGGGCCCCAATCCAG: GAGGGGGCCCCAATCCAGT
TGAGTCAGCGTCAAGCGGG: GAGTCAGCGTCAAGCGGGA
TGAGTCGGATCACTCCACA: GAGTCGGATCACTCCACAG
TGAGTGGATATGGCTGGCC: GAGTGGATATGGCTGGCCA
TGAGTTATGATTTGTGACT: GAGTTATGATTTGTGACTC
TGAGTTTGAAGAAGGTTTA: GAGTTTGAAGAAGGTTTAA
TGATATCTCCGAAGGTGAC: GATATCTCCGAAGGTGACA
TGATCCGAACCTTCTTAGG: GATCCGAACCTTCTTAGGC
TGATCGGTGATGGAGTAGT: GATCGGTGATGGAGTAGTA
TGATCGTTGCTCTCGCCCT: GATCGTTGCTCTCGCCCTA
TGATCTCACGACCCATTTT: GATCTCACGACCCATTTTC
TGATCTCATGAGTGGATAT: GATCTCATGAGTGGATATG
TGATGGAGTAGTAGATACG: GATGGAGTAGTAGATACGC
TGATTAGGCTTGACACAGA: GATTAGGCTTGACACAGAG
TGATTCTAGTCCTCAGCTT: GATTCTAGTCCTCAGCTTT
TGATTTGTGACTCTGCTTT: GATTTGTGACTCTGCTTTT
TGCAACACGTTGTCGGTTG: GCAACACGTTGTCGGTTGC
TGCAACTAGCGCAACTACT: GCAACTAGCGCAACTACTC
TGCAAGGCTTGCTCTACCC: GCAAGGCTTGCTCTACCCC
TGCAAGTGCCGTGCTTGAA: GCAAGTGCCGTGCTTGAAG
TGCACGTGTTTTCAAGTCG: GCACGTGTTTTCAAGTCGG
TGCAGTGTGCGCAAAAATC: GCAGTGTGCGCAAAAATCA
TGCATGATTAGGCTTGACA: GCATGATTAGGCTTGACAC
TGCCACCAGTGATCGTTGC: GCCACCAGTGATCGTTGCT
TGCCAGGTCGTAAGCAGAT: GCCAGGTCGTAAGCAGATA
TGCCATTTCGATCCTACCG: GCCATTTCGATCCTACCGT
TGCCCCCAACATTCTACTG: GCCCCCAACATTCTACTGT
TGCCGACATATTTTTAATT: GCCGACATATTTTTAATTC
TGCCGACTGACTATTACAT: GCCGACTGACTATTACATA
TGCCGACTTGAAGGAACGT: GCCGACTTGAAGGAACGTG
TGCCGACTTTTGCATGATT: GCCGACTTTTGCATGATTA
TGCCGGGCCCCGGGCATGC: GCCGGGCCCCGGGCATGCA
TGCCGTCAGCATGCCGGGC: GCCGTCAGCATGCCGGGCC
TGCCGTGCTTGAAGCAGGT: GCCGTGCTTGAAGCAGGTA
TGCCTATGGCGAATACTTC: GCCTATGGCGAATACTTCC
TGCCTGAGTCAGCGTCAAG: GCCTGAGTCAGCGTCAAGC
TGCCTGAGTCGGATCACTC: GCCTGAGTCGGATCACTCC
TGCCTGGACGCCAACCATG: GCCTGGACGCCAACCATGA
TGCCTTGCAGTGTGCGCAA: GCCTTGCAGTGTGCGCAAA
TGCGAACTCGCCATACTTG: GCGAACTCGCCATACTTGG
TGCGAATTGTTTAATCCCT: GCGAATTGTTTAATCCCTA
TGCGAGCGTGTTGAGGGGG: GCGAGCGTGTTGAGGGGGC
TGCGCAAAAATCAACGGGA: GCGCAAAAATCAACGGGAC
TGCGCGCCTCAGACTTCTC: GCGCGCCTCAGACTTCTCG
TGCGGCGTCATCAGGACAG: GCGGCGTCATCAGGACAGT
TGCGTATTGAACCGTCGGG: GCGTATTGAACCGTCGGGG
TGCGTTCAGACTTCTCGTG: GCGTTCAGACTTCTCGTGC
TGCTAACCGGCGGTGCCGT: GCTAACCGGCGGTGCCGTC
TGCTCTACCCCTTCTCAAT: GCTCTACCCCTTCTCAATT
TGCTCTCATGAGACGGTTC: GCTCTCATGAGACGGTTCG
TGCTCTCGCCCTATAACCC: GCTCTCGCCCTATAACCCC
TGCTGGAATGTTCTCTCAG: GCTGGAATGTTCTCTCAGA
TGCTGTCGGGCGCAAATGG: GCTGTCGGGCGCAAATGGC
TGCTTACAGGACATAGTAT: GCTTACAGGACATAGTATT
TGCTTGAAGCAGGTACTGT: GCTTGAAGCAGGTACTGTG
TGCTTTTCGTGACTGTAGT: GCTTTTCGTGACTGTAGTA
TGGAAGGATCAGACTTCTC: GGAAGGATCAGACTTCTCG
TGGAATGTTCTCTCAGAAC: GGAATGTTCTCTCAGAACA
TGGACAGCATACTATAGAC: GGACAGCATACTATAGACG
TGGACATGGTTCTCGACCA: GGACATGGTTCTCGACCAT
TGGACGCCAACCATGACCA: GGACGCCAACCATGACCAC
TGGAGCGCGATGGGGCATC: GGAGCGCGATGGGGCATCG
TGGAGTAGTAGATACGCAG: GGAGTAGTAGATACGCAGT
TGGATATGGCTGGCCACAT: GGATATGGCTGGCCACATT
TGGCAATGTAGCCGAATAG: GGCAATGTAGCCGAATAGG
TGGCATCCTTGCGCACCTT: GGCATCCTTGCGCACCTTG
TGGCCACATTCAGCGTCGC: GGCCACATTCAGCGTCGCG
TGGCGAATACTTCCATCCT: GGCGAATACTTCCATCCTC
TGGCGTAATTTTAGGGTTT: GGCGTAATTTTAGGGTTTA
TGGCTAACCTTTGATTCTA: GGCTAACCTTTGATTCTAG
TGGCTAGGAAATACCGCGT: GGCTAGGAAATACCGCGTC
TGGCTATCCCCTGCCACCA: GGCTATCCCCTGCCACCAG
TGGCTCAAGTAAAGCAGGG: GGCTCAAGTAAAGCAGGGT
TGGCTCTATCTAGAACCCA: GGCTCTATCTAGAACCCAC
TGGCTGCGAACTCGCCATA: GGCTGCGAACTCGCCATAC
TGGCTGGCCACATTCAGCG: GGCTGGCCACATTCAGCGT
TGGGCGATGTGGTGGCAAT: GGGCGATGTGGTGGCAATG
TGGGCGGCTCTCAGCTACC: GGGCGGCTCTCAGCTACCC
TGGGGCATCGTACAACAGC: GGGGCATCGTACAACAGCA
TGGGGCCGGCCGAGGATTG: GGGGCCGGCCGAGGATTGT
TGGGTGCCTTGCAGTGTGC: GGGTGCCTTGCAGTGTGCG
TGGGTTGCCTATGGCGAAT: GGGTTGCCTATGGCGAATA
TGGTGCCATTTCGATCCTA: GGTGCCATTTCGATCCTAC
TGGTGGCAATGTAGCCGAA: GGTGGCAATGTAGCCGAAT
TGGTTCTCGACCATCGTAC: GGTTCTCGACCATCGTACA
TGTAAAAGCGAGATGTCTG: GTAAAAGCGAGATGTCTGC
TGTAAAGGATCTTAACATG: GTAAAGGATCTTAACATGA
TGTACCTGAGCCTTGGGCG: GTACCTGAGCCTTGGGCGA
TGTAGCCGAATAGGTAGAC: GTAGCCGAATAGGTAGACA
TGTAGCTCGCTTCCGTCCT: GTAGCTCGCTTCCGTCCTG
TGTAGTATTCTCTCTTCAT: GTAGTATTCTCTCTTCATC
TGTATATCTCTCAAAATAT: GTATATCTCTCAAAATATC
TGTATCATCCCCCAGCTAT: GTATCATCCCCCAGCTATG
TGTATCTTACGTGCCCCCA: GTATCTTACGTGCCCCCAA
TGTATGGCTCAAGTAAAGC: GTATGGCTCAAGTAAAGCA
TGTATTAGACCTATGTAAA: GTATTAGACCTATGTAAAA
TGTCAGACTTCTCGTGCCG: GTCAGACTTCTCGTGCCGA
TGTCGGGCGCAAATGGCTA: GTCGGGCGCAAATGGCTAT
TGTCGGTTGCTGGAATGTT: GTCGGTTGCTGGAATGTTC
TGTCTGCAACACGTTGTCG: GTCTGCAACACGTTGTCGG
TGTGACTCTGCTTTTCGTG: GTGACTCTGCTTTTCGTGA
TGTGCGAGCGTGTTGAGGG: GTGCGAGCGTGTTGAGGGG
TGTGCGCAAAAATCAACGG: GTGCGCAAAAATCAACGGG
TGTGGCTAGGAAATACCGC: GTGGCTAGGAAATACCGCG
TGTGGTGGCAATGTAGCCG: GTGGTGGCAATGTAGCCGA
TGTGTAGCTCGCTTCCGTC: GTGTAGCTCGCTTCCGTCC
TGTGTGTAGCTCGCTTCCG: GTGTGTAGCTCGCTTCCGT
TGTTAGCAAACAGGCCTAA: GTTAGCAAACAGGCCTAAC
TGTTCTCTCAGAACAACGG: GTTCTCTCAGAACAACGGC
TGTTGAGGGGGCCCCAATC: GTTGAGGGGGCCCCAATCC
TGTTTAATCCCTAGATGAG: GTTTAATCCCTAGATGAGT
TGTTTGACATTCACGTTCC: GTTTGACATTCACGTTCCT
TGTTTGAGGCATGATCCGA: GTTTGAGGCATGATCCGAA
TGTTTTCAAGTCGGCAGCC: GTTTTCAAGTCGGCAGCCC
TTAAAACACCCCAGAGCAC: TAAAACACCCCAGAGCACA
TTAACATGATCTCATGAGT: TAACATGATCTCATGAGTG
TTAAGACATCGTACAACAG: TAAGACATCGTACAACAGC
TTAAGGGCCAGGACGTCAA: TAAGGGCCAGGACGTCAAC
TTAATCCCTAGATGAGTTA: TAATCCCTAGATGAGTTAT
TTAATGCCTGAGTCGGATC: TAATGCCTGAGTCGGATCA
TTAATTCCAGTCCGTGTTT: TAATTCCAGTCCGTGTTTG
TTACAGGACATAGTATTGT: TACAGGACATAGTATTGTT
TTACATATGCGGCGTCATC: TACATATGCGGCGTCATCA
TTACGGGCGAATCCTGCCT: TACGGGCGAATCCTGCCTG
TTACGTGCCCCCAACATTC: TACGTGCCCCCAACATTCT
TTACTAATCAACTCATTTC: TACTAATCAACTCATTTCC
TTAGACCCAGCAGGATCCG: TAGACCCAGCAGGATCCGA
TTAGACCTATGTAAAAGCG: TAGACCTATGTAAAAGCGA
TTAGCAAACAGGCCTAACG: TAGCAAACAGGCCTAACGT
TTAGCAATCACTGAAGCTA: TAGCAATCACTGAAGCTAT
TTAGGCTACCCGTATCAAG: TAGGCTACCCGTATCAAGT
TTAGGCTTGACACAGAGAT: TAGGCTTGACACAGAGATG
TTAGGGTTTACGGGCGAAT: TAGGGTTTACGGGCGAATC
TTATAAACACATCCCGTCG: TATAAACACATCCCGTCGA
TTATCCCGCCGCATTCGCG: TATCCCGCCGCATTCGCGG
TTATCTTCGTTCAGCTATT: TATCTTCGTTCAGCTATTC
TTATGATTTGTGACTCTGC: TATGATTTGTGACTCTGCT
TTATGGACAGCATACTATA: TATGGACAGCATACTATAG
TTCAAGTCGGCAGCCCCGA: TCAAGTCGGCAGCCCCGAA
TTCACCTCCGCTCAGAACG: TCACCTCCGCTCAGAACGC
TTCACGTTCCTAGTCAACA: TCACGTTCCTAGTCAACAT
TTCAGACTTCTCGTGCCGA: TCAGACTTCTCGTGCCGAC
TTCAGCGTCGCGGCTCCTT: TCAGCGTCGCGGCTCCTTA
TTCAGCTATTCACCTCCGC: TCAGCTATTCACCTCCGCT
TTCATCGTACAACAGCATC: TCATCGTACAACAGCATCA
TTCCAGTCCGTGTTTGACA: TCCAGTCCGTGTTTGACAT
TTCCATCCTCTTCTGCAAC: TCCATCCTCTTCTGCAACT
TTCCCGACACAAGATCCTG: TCCCGACACAAGATCCTGT
TTCCGTCCTGCGTATTGAA: TCCGTCCTGCGTATTGAAC
TTCCGTGGCTGCGAACTCG: TCCGTGGCTGCGAACTCGC
TTCCTAGTCAACATAATGG: TCCTAGTCAACATAATGGA
TTCCTCCGGAACTAACGGC: TCCTCCGGAACTAACGGCA
TTCGATCCTACCGTCGTCT: TCGATCCTACCGTCGTCTA
TTCGATTGGGCGGCTCTCA: TCGATTGGGCGGCTCTCAG
TTCGCGGCCGTACAGAGAG: TCGCGGCCGTACAGAGAGC
TTCGCTAGATGTATCTTAC: TCGCTAGATGTATCTTACG
TTCGTGACTGTAGTATTCT: TCGTGACTGTAGTATTCTC
TTCGTGGAGCGCGATGGGG: TCGTGGAGCGCGATGGGGC
TTCGTGGTGCCATTTCGAT: TCGTGGTGCCATTTCGATC
TTCGTTCAGCTATTCACCT: TCGTTCAGCTATTCACCTC
TTCTACTGTATATCTCTCA: TCTACTGTATATCTCTCAA
TTCTAGTCCTCAGCTTTAT: TCTAGTCCTCAGCTTTATC
TTCTCAATTAGCAATCACT: TCTCAATTAGCAATCACTG
TTCTCACCAAGAATGCTAA: TCTCACCAAGAATGCTAAC
TTCTCGACCATCGTACAAC: TCTCGACCATCGTACAACA
TTCTCGTGCCGACATATTT: TCTCGTGCCGACATATTTT
TTCTCGTGCCGACTGACTA: TCTCGTGCCGACTGACTAT
TTCTCGTGCCGACTTGAAG: TCTCGTGCCGACTTGAAGG
TTCTCGTGCCGACTTTTGC: TCTCGTGCCGACTTTTGCA
TTCTCTCAGAACAACGGCA: TCTCTCAGAACAACGGCAA
TTCTCTCTTCATCGTACAA: TCTCTCTTCATCGTACAAC
TTCTGCAACTAGCGCAACT: TCTGCAACTAGCGCAACTA
TTCTGCTCTCATGAGACGG: TCTGCTCTCATGAGACGGT
TTCTGTATGGCTCAAGTAA: TCTGTATGGCTCAAGTAAA
TTCTTAGGCTACCCGTATC: TCTTAGGCTACCCGTATCA
TTGAACCGTCGGGGGAGCT: TGAACCGTCGGGGGAGCTC
TTGAAGAAGGTTTAAGGGC: TGAAGAAGGTTTAAGGGCC
TTGAAGCAGGTACTGTGTG: TGAAGCAGGTACTGTGTGT
TTGAAGGAACGTGGCTCTA: TGAAGGAACGTGGCTCTAT
TTGAAGGACGTAATAGGAA: TGAAGGACGTAATAGGAAT
TTGACAATAGGTTGCTTAC: TGACAATAGGTTGCTTACA
TTGACACAGAGATGGCTAA: TGACACAGAGATGGCTAAC
TTGACATTCACGTTCCTAG: TGACATTCACGTTCCTAGT
TTGACGAACACATACTACG: TGACGAACACATACTACGT
TTGAGGCATGATCCGAACC: TGAGGCATGATCCGAACCT
TTGAGGGGGCCCCAATCCA: TGAGGGGGCCCCAATCCAG
TTGATCTCACGACCCATTT: TGATCTCACGACCCATTTT
TTGATTCTAGTCCTCAGCT: TGATTCTAGTCCTCAGCTT
TTGCAAGGCTTGCTCTACC: TGCAAGGCTTGCTCTACCC
TTGCAGTGTGCGCAAAAAT: TGCAGTGTGCGCAAAAATC
TTGCATGATTAGGCTTGAC: TGCATGATTAGGCTTGACA
TTGCCTATGGCGAATACTT: TGCCTATGGCGAATACTTC
TTGCGAATTGTTTAATCCC: TGCGAATTGTTTAATCCCT
TTGCTCTACCCCTTCTCAA: TGCTCTACCCCTTCTCAAT
TTGCTCTCGCCCTATAACC: TGCTCTCGCCCTATAACCC
TTGCTGGAATGTTCTCTCA: TGCTGGAATGTTCTCTCAG
TTGCTTACAGGACATAGTA: TGCTTACAGGACATAGTAT
TTGGGCGATGTGGTGGCAA: TGGGCGATGTGGTGGCAAT
TTGGGCGGCTCTCAGCTAC: TGGGCGGCTCTCAGCTACC
TTGGGGCCGGCCGAGGATT: TGGGGCCGGCCGAGGATTG
TTGGGTGCCTTGCAGTGTG: TGGGTGCCTTGCAGTGTGC
TTGTAAAGGATCTTAACAT: TGTAAAGGATCTTAACATG
TTGTCAGACTTCTCGTGCC: TGTCAGACTTCTCGTGCCG
TTGTCGGTTGCTGGAATGT: TGTCGGTTGCTGGAATGTT
TTGTGACTCTGCTTTTCGT: TGTGACTCTGCTTTTCGTG
TTGTGCGAGCGTGTTGAGG: TGTGCGAGCGTGTTGAGGG
TTGTTAGCAAACAGGCCTA: TGTTAGCAAACAGGCCTAA
TTGTTTAATCCCTAGATGA: TGTTTAATCCCTAGATGAG
TTGTTTGAGGCATGATCCG: TGTTTGAGGCATGATCCGA
TTTAAGGGCCAGGACGTCA: TTAAGGGCCAGGACGTCAA
TTTAATCCCTAGATGAGTT: TTAATCCCTAGATGAGTTA
TTTAATTCCAGTCCGTGTT: TTAATTCCAGTCCGTGTTT
TTTACGGGCGAATCCTGCC: TTACGGGCGAATCCTGCCT
TTTAGGGTTTACGGGCGAA: TTAGGGTTTACGGGCGAAT
TTTATCCCGCCGCATTCGC: TTATCCCGCCGCATTCGCG
TTTCAAGTCGGCAGCCCCG: TTCAAGTCGGCAGCCCCGA
TTTCCGTGGCTGCGAACTC: TTCCGTGGCTGCGAACTCG
TTTCCTCCGGAACTAACGG: TTCCTCCGGAACTAACGGC
TTTCGATCCTACCGTCGTC: TTCGATCCTACCGTCGTCT
TTTCGCTAGATGTATCTTA: TTCGCTAGATGTATCTTAC
TTTCGTGACTGTAGTATTC: TTCGTGACTGTAGTATTCT
TTTGAAGAAGGTTTAAGGG: TTGAAGAAGGTTTAAGGGC
TTTGACAATAGGTTGCTTA: TTGACAATAGGTTGCTTAC
TTTGACATTCACGTTCCTA: TTGACATTCACGTTCCTAG
TTTGAGGCATGATCCGAAC: TTGAGGCATGATCCGAACC
TTTGATTCTAGTCCTCAGC: TTGATTCTAGTCCTCAGCT
TTTGCATGATTAGGCTTGA: TTGCATGATTAGGCTTGAC
TTTGTGACTCTGCTTTTCG: TTGTGACTCTGCTTTTCGT
TTTTAATTCCAGTCCGTGT: TTTAATTCCAGTCCGTGTT
TTTTAGGGTTTACGGGCGA: TTTAGGGTTTACGGGCGAA
TTTTCAAGTCGGCAGCCCC: TTTCAAGTCGGCAGCCCCG
TTTTCCTCCGGAACTAACG: TTTCCTCCGGAACTAACGG
TTTTCGTGACTGTAGTATT: TTTCGTGACTGTAGTATTC
TTTTGCATGATTAGGCTTG: TTTGCATGATTAGGCTTGA
TTTTTAATTCCAGTCCGTG: TTTTAATTCCAGTCCGTGT