AAAAACTCAGT: AAAACTCAGTT
AAAACAAGTAC: AAACAAGTACC
AAAACCATTGT: AAACCATTGTC
AAAACCGCTAC: AAACCGCTACC
AAAACGAGAGT: AAACGAGAGTT
AAAACTCAGTT: AAACTCAGTTA
AAAACTGTATG: AAACTGTATGT
AAAATCGCGAT: AAATCGCGATT
AAAATCGCGGT: AAATCGCGGTT
AAACAAGTACC: AACAAGTACCC
AAACCATTGTC: AACCATTGTCC
AAACCCAATTC: AACCCAATTCA
AAACCGCTACC: AACCGCTACCC
AAACGAGAGTT: AACGAGAGTTA
AAACGTAACGT: AACGTAACGTC
AAACTAACCTC: AACTAACCTCC
AAACTAAGGCT: AACTAAGGCTG
AAACTACACTG: AACTACACTGG
AAACTAGTATC: AACTAGTATCT
AAACTCAGTTA: AACTCAGTTAT
AAACTGTATGT: AACTGTATGTC
AAAGAATCTGA: AAGAATCTGAA
AAAGATTAAAT: AAGATTAAATT
AAAGCGCATTC: AAGCGCATTCA
AAAGGGTTCCG: AAGGGTTCCGG
AAATACTCTTC: AATACTCTTCG
AAATATCGGGC: AATATCGGGCT
AAATATGAGTA: AATATGAGTAA
AAATCACCCCA: AATCACCCCAT
AAATCAGAAAC: AATCAGAAACT
AAATCGCGATT: AATCGCGATTC
AAATCGCGGTT: AATCGCGGTTG
AAATGGCCATC: AATGGCCATCG
AAATTGGGAAA: AATTGGGAAAA
AACAAGTACCC: ACAAGTACCCG
AACACGTCCCC: ACACGTCCCCG
AACAGTCCATA: ACAGTCCATAA
AACATTTTGCC: ACATTTTGCCT
AACCACATCGT: ACCACATCGTA
AACCATTGTCC: ACCATTGTCCT
AACCCAATTCA: ACCCAATTCAT
AACCCGACATC: ACCCGACATCT
AACCCTGAGGT: ACCCTGAGGTT
AACCGAAGTGT: ACCGAAGTGTC
AACCGACCTAT: ACCGACCTATG
AACCGATGTTA: ACCGATGTTAG
AACCGCTACCC: ACCGCTACCCA
AACCGTTTTGT: ACCGTTTTGTC
AACCTAAAGAA: ACCTAAAGAAT
AACCTCCGACA: ACCTCCGACAG
AACCTGTCTTT: ACCTGTCTTTA
AACGAGAGTTA: ACGAGAGTTAG
AACGCACACAA: ACGCACACAAA
AACGGTAGCAT: ACGGTAGCATC
AACGTAACGTC: ACGTAACGTCC
AACGTCCATTA: ACGTCCATTAG
AACGTGACGAG: ACGTGACGAGC
AACGTTCGAAA: ACGTTCGAAAT
AACGTTGGTGG: ACGTTGGTGGT
AACGTTGTCGC: ACGTTGTCGCT
AACTAACCTCC: ACTAACCTCCG
AACTAAGGCTG: ACTAAGGCTGT
AACTACACTGG: ACTACACTGGT
AACTAGTATCT: ACTAGTATCTG
AACTATGGAAT: ACTATGGAATC
AACTCAGAGCC: ACTCAGAGCCA
AACTCAGTTAT: ACTCAGTTATT
AACTGGACGTG: ACTGGACGTGA
AACTGGAGTGG: ACTGGAGTGGA
AACTGGGGGAG: ACTGGGGGAGG
AACTGTATGTC: ACTGTATGTCT
AACTTAGTTGG: ACTTAGTTGGT
AACTTATCTTG: ACTTATCTTGA
AAGAATCTGAA: AGAATCTGAAA
AAGATTAAATT: AGATTAAATTG
AAGCAACAGTC: AGCAACAGTCC
AAGCACAGCGA: AGCACAGCGAT
AAGCCGTCAGG: AGCCGTCAGGC
AAGCGAGGCCC: AGCGAGGCCCC
AAGCGCATTCA: AGCGCATTCAT
AAGCGGGACAG: AGCGGGACAGC
AAGCGGGGCCC: AGCGGGGCCCT
AAGCGTTTCTG: AGCGTTTCTGT
AAGCTAAACTA: AGCTAAACTAG
AAGGCTGTATC: AGGCTGTATCT
AAGGGCTGGGG: AGGGCTGGGGA
AAGGGTTCCGG: AGGGTTCCGGC
AAGGTCACAAT: AGGTCACAATG
AAGGTGGACCT: AGGTGGACCTG
AAGTACCCGAG: AGTACCCGAGG
AAGTCGAAATA: AGTCGAAATAC
AAGTGCAGATT: AGTGCAGATTA
AAGTGTCTAAA: AGTGTCTAAAT
AATACCCCGTC: ATACCCCGTCA
AATACTCTTCG: ATACTCTTCGC
AATAGAGGGGT: ATAGAGGGGTG
AATAGCCTCGC: ATAGCCTCGCT
AATAGGGACGG: ATAGGGACGGA
AATATCGGGCT: ATATCGGGCTC
AATATGAGTAA: ATATGAGTAAT
AATATTTCAGC: ATATTTCAGCA
AATCAAGCAAC: ATCAAGCAACA
AATCACCCCAT: ATCACCCCATG
AATCAGAAACT: ATCAGAAACTA
AATCATACTCA: ATCATACTCAA
AATCCCATGTA: ATCCCATGTAC
AATCCGACCCC: ATCCGACCCCG
AATCGCGATTC: ATCGCGATTCA
AATCGCGGTTG: ATCGCGGTTGC
AATCTGAAAAT: ATCTGAAAATC
AATCTGATACA: ATCTGATACAC
AATGAGCACTG: ATGAGCACTGA
AATGCCCGGTG: ATGCCCGGTGG
AATGCTATTAC: ATGCTATTACT
AATGGACCCAG: ATGGACCCAGG
AATGGCCATCG: ATGGCCATCGG
AATGGGTAGCT: ATGGGTAGCTA
AATTACAACCT: ATTACAACCTG
AATTCATATGC: ATTCATATGCC
AATTGGGAAAA: ATTGGGAAAAT
AATTTGATAAG: ATTTGATAAGC
AATTTGCAACC: ATTTGCAACCA
AATTTGTCATT: ATTTGTCATTC
ACAAAACCATT: CAAAACCATTG
ACAAACCCAAT: CAAACCCAATT
ACAACCTAAAG: CAACCTAAAGA
ACAACCTGTCT: CAACCTGTCTT
ACAAGTACCCG: CAAGTACCCGA
ACAATGCCCGG: CAATGCCCGGT
ACACAAAACCA: CACAAAACCAT
ACACAGATATC: CACAGATATCA
ACACCTACCAC: CACCTACCACG
ACACGTCCCCG: CACGTCCCCGC
ACACTACTTTG: CACTACTTTGA
ACACTGGTCAC: CACTGGTCACT
ACAGAGTGGGG: CAGAGTGGGGT
ACAGATATCAT: CAGATATCATG
ACAGCAACGTT: CAGCAACGTTC
ACAGCCCCGAT: CAGCCCCGATC
ACAGCCGCGAA: CAGCCGCGAAC
ACAGCGATTGA: CAGCGATTGAG
ACAGCGGTTAA: CAGCGGTTAAT
ACAGGCTTAAC: CAGGCTTAACA
ACAGGGCAGAA: CAGGGCAGAAC
ACAGTCCATAA: CAGTCCATAAG
ACATAACCGAA: CATAACCGAAG
ACATCAGAGAG: CATCAGAGAGT
ACATCCCAAAT: CATCCCAAATG
ACATCGTAGAA: CATCGTAGAAC
ACATCTCGACT: CATCTCGACTA
ACATGTGGCGG: CATGTGGCGGC
ACATTTTGCCT: CATTTTGCCTG
ACCAAGCGGGA: CCAAGCGGGAC
ACCACATCGTA: CCACATCGTAG
ACCACGAGTTG: CCACGAGTTGT
ACCACGTAACC: CCACGTAACCC
ACCACGTGCAT: CCACGTGCATA
ACCATTGTCCT: CCATTGTCCTG
ACCCAACTTAT: CCCAACTTATC
ACCCAATTCAT: CCCAATTCATA
ACCCAGGTGAT: CCCAGGTGATG
ACCCCATGCTG: CCCCATGCTGA
ACCCCGACCAC: CCCCGACCACG
ACCCCGTCATC: CCCCGTCATCT
ACCCGAAAAAC: CCCGAAAAACT
ACCCGACATCT: CCCGACATCTC
ACCCGAGGTAA: CCCGAGGTAAC
ACCCTATCTCT: CCCTATCTCTA
ACCCTGAGGTT: CCCTGAGGTTC
ACCGAAGTGTC: CCGAAGTGTCT
ACCGACCTATG: CCGACCTATGG
ACCGATGTTAG: CCGATGTTAGC
ACCGCCTAGCA: CCGCCTAGCAC
ACCGCGCGTTA: CCGCGCGTTAG
ACCGCGTGGTG: CCGCGTGGTGT
ACCGCTACCCA: CCGCTACCCAA
ACCGTATAACT: CCGTATAACTG
ACCGTTTTGTC: CCGTTTTGTCC
ACCTAAAGAAT: CCTAAAGAATC
ACCTACCACGT: CCTACCACGTG
ACCTATGGCCC: CCTATGGCCCT
ACCTCCGACAG: CCTCCGACAGC
ACCTCTCGTCC: CCTCTCGTCCA
ACCTGTCTTTA: CCTGTCTTTAT
ACCTGTTCGGG: CCTGTTCGGGT
ACCTTTTCGCG: CCTTTTCGCGT
ACGACAGAGTG: CGACAGAGTGG
ACGACATCCCA: CGACATCCCAA
ACGACCCTATC: CGACCCTATCT
ACGACGACATC: CGACGACATCC
ACGACGACGTG: CGACGACGTGA
ACGACGTGATT: CGACGTGATTG
ACGAGAGTTAG: CGAGAGTTAGT
ACGAGCTTTAC: CGAGCTTTACA
ACGAGTTGTTA: CGAGTTGTTAT
ACGCAATACCC: CGCAATACCCC
ACGCACACAAA: CGCACACAAAA
ACGCGACGACG: CGCGACGACGA
ACGCGAGAACC: CGCGAGAACCG
ACGCTATCCTC: CGCTATCCTCG
ACGGAACCGAC: CGGAACCGACC
ACGGATCTAAC: CGGATCTAACG
ACGGTAGCATC: CGGTAGCATCA
ACGGTCGGTTA: CGGTCGGTTAT
ACGTAACCCGA: CGTAACCCGAC
ACGTAACGTCC: CGTAACGTCCA
ACGTAGTCGGG: CGTAGTCGGGC
ACGTCCAATCA: CGTCCAATCAA
ACGTCCATTAG: CGTCCATTAGG
ACGTCCCCGCA: CGTCCCCGCAC
ACGTGACCAAG: CGTGACCAAGC
ACGTGACGAGC: CGTGACGAGCT
ACGTGATTGCT: CGTGATTGCTT
ACGTGCATATT: CGTGCATATTC
ACGTTCGAAAT: CGTTCGAAATC
ACGTTGGTGGT: CGTTGGTGGTT
ACGTTGTCGCT: CGTTGTCGCTG
ACTAAACGTAA: CTAAACGTAAC
ACTAACCTCCG: CTAACCTCCGA
ACTAAGGCTGT: CTAAGGCTGTA
ACTACACTGGT: CTACACTGGTC
ACTACGCGAGA: CTACGCGAGAA
ACTACTTTGAG: CTACTTTGAGC
ACTAGAGTTAA: CTAGAGTTAAC
ACTAGCAATCT: CTAGCAATCTG
ACTAGTATCTG: CTAGTATCTGG
ACTATAGTCTA: CTATAGTCTAT
ACTATGATCTG: CTATGATCTGA
ACTATGGAATC: CTATGGAATCC
ACTCAATTTGT: CTCAATTTGTC
ACTCAGAGCCA: CTCAGAGCCAT
ACTCAGTTATT: CTCAGTTATTG
ACTCATCCATG: CTCATCCATGC
ACTCGGAGATG: CTCGGAGATGT
ACTCTAAAGAT: CTCTAAAGATT
ACTCTTCACTG: CTCTTCACTGA
ACTCTTCGCTC: CTCTTCGCTCA
ACTGATAGTGG: CTGATAGTGGC
ACTGATCTGGC: CTGATCTGGCC
ACTGCTCCGAC: CTGCTCCGACG
ACTGGACGTGA: CTGGACGTGAC
ACTGGAGTCCT: CTGGAGTCCTT
ACTGGAGTGGA: CTGGAGTGGAG
ACTGGGGGAGG: CTGGGGGAGGC
ACTGGTCACTC: CTGGTCACTCG
ACTGTATGTCT: CTGTATGTCTG
ACTGTCGTACT: CTGTCGTACTC
ACTTAGTTGGT: CTTAGTTGGTA
ACTTATCTTGA: CTTATCTTGAC
ACTTGAGATGA: CTTGAGATGAT
ACTTTAAGTCG: CTTTAAGTCGA
ACTTTGAGCCG: CTTTGAGCCGG
AGAAACTAACC: GAAACTAACCT
AGAAAGCGCAT: GAAAGCGCATT
AGAACCCTGAG: GAACCCTGAGG
AGAACCGTTTT: GAACCGTTTTG
AGAACGTGACG: GAACGTGACGA
AGAACTTAGTT: GAACTTAGTTG
AGAAGGTCACA: GAAGGTCACAA
AGAATCTGAAA: GAATCTGAAAA
AGACGGTCGGT: GACGGTCGGTT
AGACTCTAAAG: GACTCTAAAGA
AGAGAGTTTCG: GAGAGTTTCGG
AGAGCCATACA: GAGCCATACAG
AGAGGGGTGAT: GAGGGGTGATG
AGAGTGGGGTG: GAGTGGGGTGT
AGAGTTAACTG: GAGTTAACTGG
AGAGTTAGTCA: GAGTTAGTCAT
AGAGTTTCGGG: GAGTTTCGGGG
AGATATCATGC: GATATCATGCA
AGATGATTCTC: GATGATTCTCA
AGATGTCTTAG: GATGTCTTAGG
AGATTAAATTG: GATTAAATTGG
AGATTAACACG: GATTAACACGT
AGATTAAGCGA: GATTAAGCGAG
AGCAAAACGAG: GCAAAACGAGA
AGCAACAGTCC: GCAACAGTCCA
AGCAACGTTCG: GCAACGTTCGA
AGCAAGCTAAA: GCAAGCTAAAC
AGCAATCTGAT: GCAATCTGATA
AGCACAGCGAT: GCACAGCGATT
AGCACTCATCC: GCACTCATCCA
AGCACTGATCT: GCACTGATCTG
AGCATAGCTGC: GCATAGCTGCT
AGCATCAATAG: GCATCAATAGG
AGCATTTGTAC: GCATTTGTACT
AGCCATACAGG: GCCATACAGGC
AGCCCCGATCG: GCCCCGATCGA
AGCCCCTGGTT: GCCCCTGGTTA
AGCCGATTAGG: GCCGATTAGGG
AGCCGCGAACT: GCCGCGAACTC
AGCCGGCGTGT: GCCGGCGTGTC
AGCCGTCAGGC: GCCGTCAGGCT
AGCCTCGCTGT: GCCTCGCTGTC
AGCGAGGCCCC: GCGAGGCCCCT
AGCGATTGAGT: GCGATTGAGTT
AGCGCATTCAT: GCGCATTCATT
AGCGGGACAGC: GCGGGACAGCC
AGCGGGGCCCT: GCGGGGCCCTA
AGCGGTTAATA: GCGGTTAATAG
AGCGTTTCTGT: GCGTTTCTGTA
AGCTAAACTAG: GCTAAACTAGT
AGCTAAATATC: GCTAAATATCG
AGCTATTGCAT: GCTATTGCATA
AGCTGACGCTA: GCTGACGCTAT
AGCTGCTGTCA: GCTGCTGTCAG
AGCTTGAGGCA: GCTTGAGGCAG
AGCTTGCCGGG: GCTTGCCGGGA
AGCTTTACAGC: GCTTTACAGCA
AGCTTTCACTA: GCTTTCACTAC
AGGCAACGTTG: GGCAACGTTGT
AGGCAGTTAAA: GGCAGTTAAAA
AGGCCCCTTTC: GGCCCCTTTCA
AGGCCGCTTCC: GGCCGCTTCCC
AGGCTGTATCT: GGCTGTATCTC
AGGCTTAACAT: GGCTTAACATT
AGGCTTCGGGT: GGCTTCGGGTC
AGGGACGGAAC: GGGACGGAACC
AGGGCAGAACC: GGGCAGAACCC
AGGGCATATCG: GGGCATATCGG
AGGGCGACCGT: GGGCGACCGTA
AGGGCTGGGGA: GGGCTGGGGAG
AGGGGTATCCT: GGGGTATCCTA
AGGGGTGATGG: GGGGTGATGGC
AGGGTAATTTG: GGGTAATTTGC
AGGGTTCCGGC: GGGTTCCGGCT
AGGTAACGGTA: GGTAACGGTAG
AGGTCACAATG: GGTCACAATGC
AGGTCCAGCCC: GGTCCAGCCCC
AGGTGATGGTG: GGTGATGGTGC
AGGTGGACCTG: GGTGGACCTGT
AGGTTCCCGAC: GGTTCCCGACG
AGTAATGAGCA: GTAATGAGCAC
AGTACCCGAGG: GTACCCGAGGT
AGTAGACGGTC: GTAGACGGTCG
AGTATCAGTCC: GTATCAGTCCG
AGTATCTGGCT: GTATCTGGCTT
AGTCATGGGTA: GTCATGGGTAC
AGTCCATAAGC: GTCCATAAGCG
AGTCCGATAGT: GTCCGATAGTT
AGTCCTTGGGC: GTCCTTGGGCC
AGTCGAAATAC: GTCGAAATACT
AGTCGATGGTA: GTCGATGGTAT
AGTCGGGCAAA: GTCGGGCAAAC
AGTCGTCCATT: GTCGTCCATTC
AGTCTATTAAA: GTCTATTAAAA
AGTGCAGATTA: GTGCAGATTAA
AGTGGAGGGCG: GTGGAGGGCGA
AGTGGCGGCAC: GTGGCGGCACA
AGTGGGGTGTC: GTGGGGTGTCT
AGTGTCTAAAT: GTGTCTAAATA
AGTTAAAACCG: GTTAAAACCGC
AGTTAACTGGA: GTTAACTGGAG
AGTTAGGGCAT: GTTAGGGCATA
AGTTAGTCATG: GTTAGTCATGG
AGTTATTGCAG: GTTATTGCAGT
AGTTCCGGCTT: GTTCCGGCTTC
AGTTGAATCAT: GTTGAATCATA
AGTTGGTACGT: GTTGGTACGTC
AGTTGTTATAT: GTTGTTATATT
AGTTTCGGGGT: GTTTCGGGGTC
AGTTTTCATGC: GTTTTCATGCA
ATAAACTAAGG: TAAACTAAGGC
ATAACCGAAGT: TAACCGAAGTG
ATAACTGGACG: TAACTGGACGT
ATAAGCGGGGC: TAAGCGGGGCC
ATAAGCGTTTC: TAAGCGTTTCT
ATACACTACTT: TACACTACTTT
ATACAGGCTTA: TACAGGCTTAA
ATACCCCGTCA: TACCCCGTCAT
ATACTCAATTT: TACTCAATTTG
ATACTCTTCGC: TACTCTTCGCT
ATAGAAAGCGC: TAGAAAGCGCA
ATAGAGGGGTG: TAGAGGGGTGA
ATAGCATAGCT: TAGCATAGCTG
ATAGCCTCGCT: TAGCCTCGCTG
ATAGCTGCTGT: TAGCTGCTGTC
ATAGGGACGGA: TAGGGACGGAA
ATAGTAGACGG: TAGTAGACGGT
ATAGTCTATTA: TAGTCTATTAA
ATAGTGGCGGC: TAGTGGCGGCA
ATAGTTCCGGC: TAGTTCCGGCT
ATATAAACTAA: TATAAACTAAG
ATATATGGCGT: TATATGGCGTT
ATATCATGCAG: TATCATGCAGC
ATATCCGCGGA: TATCCGCGGAC
ATATCGGCGGG: TATCGGCGGGT
ATATCGGGCTC: TATCGGGCTCT
ATATGAGTAAT: TATGAGTAATG
ATATGCCCCGT: TATGCCCCGTA
ATATGGCGTTA: TATGGCGTTAT
ATATTCATGGA: TATTCATGGAT
ATATTTCAGCA: TATTTCAGCAA
ATATTTGGACG: TATTTGGACGA
ATCAAGCAACA: TCAAGCAACAG
ATCAATAGGGA: TCAATAGGGAC
ATCACCCCATG: TCACCCCATGC
ATCACGCAATA: TCACGCAATAC
ATCAGAAACTA: TCAGAAACTAA
ATCAGAGAGTT: TCAGAGAGTTT
ATCAGTCCGAT: TCAGTCCGATA
ATCATACTCAA: TCATACTCAAT
ATCATGCAGCA: TCATGCAGCAT
ATCCATGCAGA: TCCATGCAGAC
ATCCCAAATGG: TCCCAAATGGC
ATCCCATGTAC: TCCCATGTACC
ATCCGACCCCG: TCCGACCCCGA
ATCCGCGGACC: TCCGCGGACCA
ATCCGGCCCAC: TCCGGCCCACA
ATCCGTGACTG: TCCGTGACTGC
ATCCTAAGCCG: TCCTAAGCCGT
ATCCTCGCGCA: TCCTCGCGCAC
ATCGACCGCGC: TCGACCGCGCG
ATCGCGATTCA: TCGCGATTCAG
ATCGCGGTTGC: TCGCGGTTGCA
ATCGGCGGGTG: TCGGCGGGTGG
ATCGGCTGGCT: TCGGCTGGCTA
ATCGGGCTCTT: TCGGGCTCTTC
ATCGTAGAACT: TCGTAGAACTT
ATCTAACGCAC: TCTAACGCACA
ATCTCAATGCT: TCTCAATGCTA
ATCTCGACTAT: TCTCGACTATA
ATCTCTAATAT: TCTCTAATATT
ATCTGAAAATC: TCTGAAAATCG
ATCTGAGTCGA: TCTGAGTCGAT
ATCTGATACAC: TCTGATACACT
ATCTGCACCCG: TCTGCACCCGA
ATCTGGCCGTT: TCTGGCCGTTA
ATCTGGCTTGC: TCTGGCTTGCT
ATCTTGACCTC: TCTTGACCTCT
ATCTTGTGAGT: TCTTGTGAGTC
ATGACACCTAC: TGACACCTACC
ATGAGCACTGA: TGAGCACTGAT
ATGAGTAATGA: TGAGTAATGAG
ATGATCTGAGT: TGATCTGAGTC
ATGATGTACGC: TGATGTACGCG
ATGATTCTCAA: TGATTCTCAAC
ATGCAGACTCT: TGCAGACTCTA
ATGCAGCATTT: TGCAGCATTTG
ATGCAGTTAGG: TGCAGTTAGGG
ATGCCAATTAC: TGCCAATTACA
ATGCCCCGTAC: TGCCCCGTACT
ATGCCCGGTGG: TGCCCGGTGGA
ATGCGAAAACA: TGCGAAAACAA
ATGCTATTACT: TGCTATTACTA
ATGCTGATGCG: TGCTGATGCGA
ATGGAATCCCA: TGGAATCCCAT
ATGGACCCAGG: TGGACCCAGGT
ATGGATAGCAT: TGGATAGCATA
ATGGCCATCGG: TGGCCATCGGC
ATGGCCCTGGC: TGGCCCTGGCC
ATGGCGTTATC: TGGCGTTATCA
ATGGCTCCCTA: TGGCTCCCTAA
ATGGGTACGGA: TGGGTACGGAT
ATGGGTAGCTA: TGGGTAGCTAA
ATGGTATATCC: TGGTATATCCG
ATGGTGCAACT: TGGTGCAACTG
ATGGTTCGCGC: TGGTTCGCGCA
ATGTACCGCCT: TGTACCGCCTA
ATGTACGCGAC: TGTACGCGACG
ATGTCTGGGGG: TGTCTGGGGGA
ATGTCTTAGGT: TGTCTTAGGTC
ATGTGGCGGCA: TGTGGCGGCAC
ATGTTAGCTTG: TGTTAGCTTGA
ATGTTTTTCGT: TGTTTTTCGTT
ATTAAAACTGT: TTAAAACTGTA
ATTAAATTGGG: TTAAATTGGGA
ATTAACACGTC: TTAACACGTCC
ATTAAGCGAGG: TTAAGCGAGGC
ATTAATGGACC: TTAATGGACCC
ATTACAACCTG: TTACAACCTGT
ATTACTAAACG: TTACTAAACGT
ATTACTAGCAA: TTACTAGCAAT
ATTAGGGGTAT: TTAGGGGTATC
ATTAGGGTAAT: TTAGGGTAATT
ATTCACGACGA: TTCACGACGAC
ATTCAGCTTGC: TTCAGCTTGCC
ATTCAGGCCGC: TTCAGGCCGCT
ATTCATATGCC: TTCATATGCCC
ATTCATGGATA: TTCATGGATAG
ATTCATTCGGT: TTCATTCGGTC
ATTCGGTCCCG: TTCGGTCCCGA
ATTCTCAACCG: TTCTCAACCGA
ATTGAGTTGAA: TTGAGTTGAAT
ATTGCAGTATC: TTGCAGTATCA
ATTGCATAGAA: TTGCATAGAAA
ATTGCTTGGAC: TTGCTTGGACA
ATTGGGAAAAT: TTGGGAAAATC
ATTGTCCTGCT: TTGTCCTGCTT
ATTTCAGCAAG: TTTCAGCAAGC
ATTTGATAAGC: TTTGATAAGCG
ATTTGCAACCA: TTTGCAACCAC
ATTTGGACGAC: TTTGGACGACC
ATTTGTACTAT: TTTGTACTATG
ATTTGTCATTC: TTTGTCATTCA
ATTTTGCCTGG: TTTTGCCTGGC
CAAAACCATTG: AAAACCATTGT
CAAAACGAGAG: AAAACGAGAGT
CAAACCCAATT: AAACCCAATTC
CAAACTACACT: AAACTACACTG
CAAATGGCCAT: AAATGGCCATC
CAACAGTCCAT: AACAGTCCATA
CAACCACATCG: AACCACATCGT
CAACCGATGTT: AACCGATGTTA
CAACCTAAAGA: AACCTAAAGAA
CAACCTGTCTT: AACCTGTCTTT
CAACGTTCGAA: AACGTTCGAAA
CAACGTTGTCG: AACGTTGTCGC
CAACTGGGGGA: AACTGGGGGAG
CAACTTATCTT: AACTTATCTTG
CAAGCAACAGT: AAGCAACAGTC
CAAGCGGGACA: AAGCGGGACAG
CAAGCTAAACT: AAGCTAAACTA
CAAGTACCCGA: AAGTACCCGAG
CAATACCCCGT: AATACCCCGTC
CAATAGGGACG: AATAGGGACGG
CAATCAAGCAA: AATCAAGCAAC
CAATCTGATAC: AATCTGATACA
CAATGCCCGGT: AATGCCCGGTG
CAATGCTATTA: AATGCTATTAC
CAATGGGTAGC: AATGGGTAGCT
CAATTACAACC: AATTACAACCT
CAATTCATATG: AATTCATATGC
CAATTTGTCAT: AATTTGTCATT
CACAAAACCAT: ACAAAACCATT
CACAAACCCAA: ACAAACCCAAT
CACAACCTAAA: ACAACCTAAAG
CACAATGCCCG: ACAATGCCCGG
CACACAAAACC: ACACAAAACCA
CACAGATATCA: ACAGATATCAT
CACAGCGATTG: ACAGCGATTGA
CACAGCGGTTA: ACAGCGGTTAA
CACAGGGCAGA: ACAGGGCAGAA
CACATCAGAGA: ACATCAGAGAG
CACATCGTAGA: ACATCGTAGAA
CACATGTGGCG: ACATGTGGCGG
CACCCCATGCT: ACCCCATGCTG
CACCCGAAAAA: ACCCGAAAAAC
CACCTACCACG: ACCTACCACGT
CACCTTTTCGC: ACCTTTTCGCG
CACGACGACAT: ACGACGACATC
CACGAGTTGTT: ACGAGTTGTTA
CACGCAATACC: ACGCAATACCC
CACGTAACCCG: ACGTAACCCGA
CACGTCCCCGC: ACGTCCCCGCA
CACGTGCATAT: ACGTGCATATT
CACTACGCGAG: ACTACGCGAGA
CACTACTTTGA: ACTACTTTGAG
CACTCATCCAT: ACTCATCCATG
CACTCGGAGAT: ACTCGGAGATG
CACTGATAGTG: ACTGATAGTGG
CACTGATCTGG: ACTGATCTGGC
CACTGGTCACT: ACTGGTCACTC
CACTGTCGTAC: ACTGTCGTACT
CACTTGAGATG: ACTTGAGATGA
CAGAAACTAAC: AGAAACTAACC
CAGAACCCTGA: AGAACCCTGAG
CAGAACGTGAC: AGAACGTGACG
CAGAAGGTCAC: AGAAGGTCACA
CAGACTCTAAA: AGACTCTAAAG
CAGAGAGTTTC: AGAGAGTTTCG
CAGAGCCATAC: AGAGCCATACA
CAGAGTGGGGT: AGAGTGGGGTG
CAGATATCATG: AGATATCATGC
CAGATTAAGCG: AGATTAAGCGA
CAGCAACGTTC: AGCAACGTTCG
CAGCAAGCTAA: AGCAAGCTAAA
CAGCATTTGTA: AGCATTTGTAC
CAGCCCCGATC: AGCCCCGATCG
CAGCCCCTGGT: AGCCCCTGGTT
CAGCCGCGAAC: AGCCGCGAACT
CAGCGATTGAG: AGCGATTGAGT
CAGCGGTTAAT: AGCGGTTAATA
CAGCTTGCCGG: AGCTTGCCGGG
CAGGCCGCTTC: AGGCCGCTTCC
CAGGCTTAACA: AGGCTTAACAT
CAGGCTTCGGG: AGGCTTCGGGT
CAGGGCAGAAC: AGGGCAGAACC
CAGGTGATGGT: AGGTGATGGTG
CAGTATCAGTC: AGTATCAGTCC
CAGTCCATAAG: AGTCCATAAGC
CAGTCCGATAG: AGTCCGATAGT
CAGTCGTCCAT: AGTCGTCCATT
CAGTTAAAACC: AGTTAAAACCG
CAGTTAGGGCA: AGTTAGGGCAT
CAGTTATTGCA: AGTTATTGCAG
CATAACCGAAG: ATAACCGAAGT
CATAAGCGGGG: ATAAGCGGGGC
CATACAGGCTT: ATACAGGCTTA
CATACTCAATT: ATACTCAATTT
CATAGAAAGCG: ATAGAAAGCGC
CATAGCTGCTG: ATAGCTGCTGT
CATAGTAGACG: ATAGTAGACGG
CATATCGGCGG: ATATCGGCGGG
CATATGCCCCG: ATATGCCCCGT
CATATTCATGG: ATATTCATGGA
CATCAATAGGG: ATCAATAGGGA
CATCAGAGAGT: ATCAGAGAGTT
CATCCATGCAG: ATCCATGCAGA
CATCCCAAATG: ATCCCAAATGG
CATCGGCTGGC: ATCGGCTGGCT
CATCGTAGAAC: ATCGTAGAACT
CATCTCGACTA: ATCTCGACTAT
CATCTGCACCC: ATCTGCACCCG
CATGATGTACG: ATGATGTACGC
CATGCAGACTC: ATGCAGACTCT
CATGCAGCATT: ATGCAGCATTT
CATGCAGTTAG: ATGCAGTTAGG
CATGCTGATGC: ATGCTGATGCG
CATGGATAGCA: ATGGATAGCAT
CATGGGTACGG: ATGGGTACGGA
CATGGTTCGCG: ATGGTTCGCGC
CATGTACCGCC: ATGTACCGCCT
CATGTGGCGGC: ATGTGGCGGCA
CATTAGGGGTA: ATTAGGGGTAT
CATTCACGACG: ATTCACGACGA
CATTCAGGCCG: ATTCAGGCCGC
CATTCATTCGG: ATTCATTCGGT
CATTCGGTCCC: ATTCGGTCCCG
CATTGTCCTGC: ATTGTCCTGCT
CATTTGTACTA: ATTTGTACTAT
CATTTTGCCTG: ATTTTGCCTGG
CCAAATGGCCA: CAAATGGCCAT
CCAACTTATCT: CAACTTATCTT
CCAAGCGGGAC: CAAGCGGGACA
CCAATCAAGCA: CAATCAAGCAA
CCAATTACAAC: CAATTACAACC
CCAATTCATAT: CAATTCATATG
CCACAACCTAA: CACAACCTAAA
CCACATCGTAG: CACATCGTAGA
CCACATGTGGC: CACATGTGGCG
CCACGAGTTGT: CACGAGTTGTT
CCACGTAACCC: CACGTAACCCG
CCACGTGCATA: CACGTGCATAT
CCAGCCCCTGG: CAGCCCCTGGT
CCAGGTGATGG: CAGGTGATGGT
CCATAAGCGGG: CATAAGCGGGG
CCATACAGGCT: CATACAGGCTT
CCATAGTAGAC: CATAGTAGACG
CCATCGGCTGG: CATCGGCTGGC
CCATGATGTAC: CATGATGTACG
CCATGCAGACT: CATGCAGACTC
CCATGCTGATG: CATGCTGATGC
CCATGTACCGC: CATGTACCGCC
CCATTAGGGGT: CATTAGGGGTA
CCATTCACGAC: CATTCACGACG
CCATTGTCCTG: CATTGTCCTGC
CCCAAATGGCC: CCAAATGGCCA
CCCAACTTATC: CCAACTTATCT
CCCAATTCATA: CCAATTCATAT
CCCACAACCTA: CCACAACCTAA
CCCAGGTGATG: CCAGGTGATGG
CCCATGCTGAT: CCATGCTGATG
CCCATGTACCG: CCATGTACCGC
CCCCATGCTGA: CCCATGCTGAT
CCCCGACCACG: CCCGACCACGT
CCCCGATCGAC: CCCGATCGACC
CCCCGCACATC: CCCGCACATCA
CCCCGTACTTT: CCCGTACTTTA
CCCCGTCATCT: CCCGTCATCTG
CCCCTCTATGC: CCCTCTATGCC
CCCCTGGTTAT: CCCTGGTTATG
CCCCTTTCATG: CCCTTTCATGG
CCCGAAAAACT: CCGAAAAACTC
CCCGACATCTC: CCGACATCTCG
CCCGACCACGT: CCGACCACGTA
CCCGACGACAG: CCGACGACAGA
CCCGAGGTAAC: CCGAGGTAACG
CCCGATCGACC: CCGATCGACCG
CCCGATTACTA: CCGATTACTAA
CCCGCACATCA: CCGCACATCAG
CCCGGTGGACT: CCGGTGGACTG
CCCGTACTTTA: CCGTACTTTAA
CCCGTCATCTG: CCGTCATCTGC
CCCTAAGGTGG: CCTAAGGTGGA
CCCTATCCGTG: CCTATCCGTGA
CCCTATCTCTA: CCTATCTCTAA
CCCTCGTAACG: CCTCGTAACGT
CCCTCTATGCC: CCTCTATGCCA
CCCTGAGGTTC: CCTGAGGTTCC
CCCTGGCCATA: CCTGGCCATAG
CCCTGGTTATG: CCTGGTTATGT
CCCTTTCATGG: CCTTTCATGGT
CCGAAAAACTC: CGAAAAACTCA
CCGAAGTGTCT: CGAAGTGTCTA
CCGACAGCCGC: CGACAGCCGCG
CCGACATCTCG: CGACATCTCGA
CCGACCACGTA: CGACCACGTAA
CCGACCCCGAC: CGACCCCGACC
CCGACCTATGG: CGACCTATGGC
CCGACGACAGA: CGACGACAGAG
CCGACGTAGTC: CGACGTAGTCG
CCGACTAGAGT: CGACTAGAGTT
CCGAGGTAACG: CGAGGTAACGG
CCGATAGTTCC: CGATAGTTCCG
CCGATCGACCG: CGATCGACCGC
CCGATGTTAGC: CGATGTTAGCT
CCGATTACTAA: CGATTACTAAA
CCGATTAGGGT: CGATTAGGGTA
CCGCACATCAG: CGCACATCAGA
CCGCCTAGCAC: CGCCTAGCACT
CCGCGAACTCA: CGCGAACTCAG
CCGCGCGTTAG: CGCGCGTTAGC
CCGCGGACCAC: CGCGGACCACG
CCGCGTGGTGT: CGCGTGGTGTA
CCGCTACCCAA: CGCTACCCAAC
CCGCTTCCCCT: CGCTTCCCCTC
CCGGCCCACAA: CGGCCCACAAC
CCGGCGTGTCG: CGGCGTGTCGA
CCGGCTAGCAA: CGGCTAGCAAA
CCGGCTTCGGA: CGGCTTCGGAC
CCGGGAACTAT: CGGGAACTATG
CCGGTGGACTG: CGGTGGACTGG
CCGTACTTTAA: CGTACTTTAAG
CCGTATAACTG: CGTATAACTGG
CCGTCAGGCTT: CGTCAGGCTTC
CCGTCATCTGC: CGTCATCTGCA
CCGTGACTGCT: CGTGACTGCTC
CCGTTATGACA: CGTTATGACAC
CCGTTTTGTCC: CGTTTTGTCCT
CCTAAAGAATC: CTAAAGAATCT
CCTAAGCCGTC: CTAAGCCGTCA
CCTAAGGTGGA: CTAAGGTGGAC
CCTACCACGTG: CTACCACGTGC
CCTAGCACTCA: CTAGCACTCAT
CCTATCCGTGA: CTATCCGTGAC
CCTATCTCTAA: CTATCTCTAAT
CCTATGGCCCT: CTATGGCCCTG
CCTCCGACAGC: CTCCGACAGCC
CCTCGCGCACC: CTCGCGCACCT
CCTCGCTGTCG: CTCGCTGTCGG
CCTCGTAACGT: CTCGTAACGTT
CCTCTATGCCA: CTCTATGCCAA
CCTCTCGTCCA: CTCTCGTCCAT
CCTGAGGTTCC: CTGAGGTTCCC
CCTGATATAAA: CTGATATAAAC
CCTGATCCGGC: CTGATCCGGCC
CCTGCTTCAGA: CTGCTTCAGAA
CCTGGCCATAG: CTGGCCATAGT
CCTGGCTGGTG: CTGGCTGGTGA
CCTGGTTATGT: CTGGTTATGTT
CCTGTCTTTAT: CTGTCTTTATT
CCTGTTCGGGT: CTGTTCGGGTC
CCTTGGGCCGA: CTTGGGCCGAC
CCTTTCATGGT: CTTTCATGGTT
CCTTTTCGCGT: CTTTTCGCGTA
CGAAAAACTCA: GAAAAACTCAG
CGAAAACAAGT: GAAAACAAGTA
CGAAATACTCT: GAAATACTCTT
CGAAATCAGAA: GAAATCAGAAA
CGAACTCAGAG: GAACTCAGAGC
CGAAGTGTCTA: GAAGTGTCTAA
CGAATTTGATA: GAATTTGATAA
CGACAGAGTGG: GACAGAGTGGG
CGACAGCCGCG: GACAGCCGCGA
CGACATCCCAA: GACATCCCAAA
CGACATCTCGA: GACATCTCGAC
CGACCACGTAA: GACCACGTAAC
CGACCCCGACC: GACCCCGACCA
CGACCCTATCT: GACCCTATCTC
CGACCGCGCGT: GACCGCGCGTT
CGACCGTATAA: GACCGTATAAC
CGACCTATGGC: GACCTATGGCC
CGACGACAGAG: GACGACAGAGT
CGACGACATCC: GACGACATCCC
CGACGACGACG: GACGACGACGT
CGACGACGTGA: GACGACGTGAT
CGACGTAGTCG: GACGTAGTCGG
CGACGTGATTG: GACGTGATTGC
CGACTAGAGTT: GACTAGAGTTA
CGACTATAGTC: GACTATAGTCT
CGAGAACCGTT: GAGAACCGTTT
CGAGAGTTAGT: GAGAGTTAGTC
CGAGATTAACA: GAGATTAACAC
CGAGCTTTACA: GAGCTTTACAG
CGAGGCCCCTT: GAGGCCCCTTT
CGAGGTAACGG: GAGGTAACGGT
CGAGTTGTTAT: GAGTTGTTATA
CGATAGTTCCG: GATAGTTCCGG
CGATATATGGC: GATATATGGCG
CGATCGACCGC: GATCGACCGCG
CGATGGTATAT: GATGGTATATC
CGATGTTAGCT: GATGTTAGCTT
CGATTACTAAA: GATTACTAAAC
CGATTAGGGTA: GATTAGGGTAA
CGATTCAGCTT: GATTCAGCTTG
CGATTGAGTTG: GATTGAGTTGA
CGCAATACCCC: GCAATACCCCG
CGCAATGGGTA: GCAATGGGTAG
CGCACACAAAA: GCACACAAAAC
CGCACATCAGA: GCACATCAGAG
CGCACCTTTTC: GCACCTTTTCG
CGCATTCATTC: GCATTCATTCG
CGCCTAGCACT: GCCTAGCACTC
CGCGAACTCAG: GCGAACTCAGA
CGCGACGACGA: GCGACGACGAC
CGCGAGAACCG: GCGAGAACCGT
CGCGATTCAGC: GCGATTCAGCT
CGCGCAATGGG: GCGCAATGGGT
CGCGCACCTTT: GCGCACCTTTT
CGCGCGTTAGC: GCGCGTTAGCT
CGCGGACCACG: GCGGACCACGA
CGCGGTTGCAC: GCGGTTGCACT
CGCGTAAATCA: GCGTAAATCAC
CGCGTGGTGTA: GCGTGGTGTAG
CGCGTTAGCTA: GCGTTAGCTAT
CGCTACCCAAC: GCTACCCAACT
CGCTATCCTCG: GCTATCCTCGC
CGCTCACAGGG: GCTCACAGGGC
CGCTGCCACAT: GCTGCCACATG
CGCTGTCGGGC: GCTGTCGGGCC
CGCTTCCCCTC: GCTTCCCCTCT
CGGAACCGACC: GGAACCGACCT
CGGACCACGAG: GGACCACGAGT
CGGACCGCGTG: GGACCGCGTGG
CGGAGATGTCT: GGAGATGTCTT
CGGATCTAACG: GGATCTAACGC
CGGCACAAACC: GGCACAAACCC
CGGCACAGCGG: GGCACAGCGGT
CGGCCCACAAC: GGCCCACAACC
CGGCGGGTGGC: GGCGGGTGGCG
CGGCGTGTCGA: GGCGTGTCGAG
CGGCTAGCAAA: GGCTAGCAAAA
CGGCTGGCTAA: GGCTGGCTAAG
CGGCTTCGGAC: GGCTTCGGACC
CGGGAACTATG: GGGAACTATGG
CGGGACAGCCC: GGGACAGCCCC
CGGGCAAACTA: GGGCAAACTAC
CGGGCCCTCGT: GGGCCCTCGTA
CGGGCTCTTCT: GGGCTCTTCTT
CGGGGCCCTAT: GGGGCCCTATC
CGGGGTCTAGT: GGGGTCTAGTT
CGGGTCACTGT: GGGTCACTGTC
CGGGTCGAATT: GGGTCGAATTT
CGGGTGGCGTG: GGGTGGCGTGA
CGGTAGCATCA: GGTAGCATCAA
CGGTCCCGATT: GGTCCCGATTA
CGGTCGGTTAT: GGTCGGTTATC
CGGTGGACTGG: GGTGGACTGGA
CGGTTAATAGA: GGTTAATAGAG
CGGTTATCTTG: GGTTATCTTGT
CGGTTGCACTT: GGTTGCACTTG
CGTAAATCACC: GTAAATCACCC
CGTAACCCGAC: GTAACCCGACA
CGTAACGTCCA: GTAACGTCCAT
CGTAACGTTGG: GTAACGTTGGT
CGTACTCTTCA: GTACTCTTCAC
CGTACTTTAAG: GTACTTTAAGT
CGTAGAACTTA: GTAGAACTTAG
CGTAGTCGGGC: GTAGTCGGGCA
CGTATAACTGG: GTATAACTGGA
CGTCAGGCTTC: GTCAGGCTTCG
CGTCATCTGCA: GTCATCTGCAC
CGTCCAATCAA: GTCCAATCAAG
CGTCCATGATG: GTCCATGATGT
CGTCCATTAGG: GTCCATTAGGG
CGTCCATTCAC: GTCCATTCACG
CGTCCCCGCAC: GTCCCCGCACA
CGTGAAGGGCT: GTGAAGGGCTG
CGTGACCAAGC: GTGACCAAGCG
CGTGACGAGCT: GTGACGAGCTT
CGTGACTGCTC: GTGACTGCTCC
CGTGATTGCTT: GTGATTGCTTG
CGTGCATATTC: GTGCATATTCA
CGTGGTGTAGC: GTGGTGTAGCT
CGTGTCGAGAT: GTGTCGAGATT
CGTTAGCTATT: GTTAGCTATTG
CGTTATCACGC: GTTATCACGCA
CGTTATGACAC: GTTATGACACC
CGTTCCTGATC: GTTCCTGATCC
CGTTCGAAATC: GTTCGAAATCA
CGTTGGTGGTT: GTTGGTGGTTC
CGTTGTCGCTG: GTTGTCGCTGC
CGTTTCTGTAA: GTTTCTGTAAG
CGTTTTGTCCT: GTTTTGTCCTG
CTAAACGTAAC: TAAACGTAACG
CTAAACTAGTA: TAAACTAGTAT
CTAAAGAATCT: TAAAGAATCTG
CTAAAGATTAA: TAAAGATTAAA
CTAAATATCGG: TAAATATCGGG
CTAAATATGAG: TAAATATGAGT
CTAACCTCCGA: TAACCTCCGAC
CTAACGCACAC: TAACGCACACA
CTAAGCCGTCA: TAAGCCGTCAG
CTAAGGCTGTA: TAAGGCTGTAT
CTAAGGTGGAC: TAAGGTGGACC
CTAAGTGCAGA: TAAGTGCAGAT
CTAATATTTCA: TAATATTTCAG
CTACACTGGTC: TACACTGGTCA
CTACCACGTGC: TACCACGTGCA
CTACCCAACTT: TACCCAACTTA
CTACGCGAGAA: TACGCGAGAAC
CTACTTTGAGC: TACTTTGAGCC
CTAGAGTTAAC: TAGAGTTAACT
CTAGCAAAACG: TAGCAAAACGA
CTAGCAATCTG: TAGCAATCTGA
CTAGCACTCAT: TAGCACTCATC
CTAGTATCTGG: TAGTATCTGGC
CTAGTTTTCAT: TAGTTTTCATG
CTATAGTCTAT: TATAGTCTATT
CTATCCGTGAC: TATCCGTGACT
CTATCCTCGCG: TATCCTCGCGC
CTATCTCTAAT: TATCTCTAATA
CTATGATCTGA: TATGATCTGAG
CTATGCCAATT: TATGCCAATTA
CTATGGAATCC: TATGGAATCCC
CTATGGCCCTG: TATGGCCCTGG
CTATTAAAACT: TATTAAAACTG
CTATTACTAGC: TATTACTAGCA
CTATTGCATAG: TATTGCATAGA
CTCAACCGATG: TCAACCGATGT
CTCAATGCTAT: TCAATGCTATT
CTCAATTTGTC: TCAATTTGTCA
CTCACAGGGCA: TCACAGGGCAG
CTCAGAGCCAT: TCAGAGCCATA
CTCAGTTATTG: TCAGTTATTGC
CTCATCCATGC: TCATCCATGCA
CTCCCTAAGGT: TCCCTAAGGTG
CTCCGACAGCC: TCCGACAGCCG
CTCCGACGTAG: TCCGACGTAGT
CTCGACTATAG: TCGACTATAGT
CTCGCGCACCT: TCGCGCACCTT
CTCGCTGTCGG: TCGCTGTCGGG
CTCGGAGATGT: TCGGAGATGTC
CTCGTAACGTT: TCGTAACGTTG
CTCGTCCATGA: TCGTCCATGAT
CTCTAAAGATT: TCTAAAGATTA
CTCTAATATTT: TCTAATATTTC
CTCTATGCCAA: TCTATGCCAAT
CTCTCGTCCAT: TCTCGTCCATG
CTCTTCACTGA: TCTTCACTGAT
CTCTTCGCTCA: TCTTCGCTCAC
CTCTTCTTAAA: TCTTCTTAAAG
CTGAAAATCGC: TGAAAATCGCG
CTGACGCTATC: TGACGCTATCC
CTGAGGTTCCC: TGAGGTTCCCG
CTGAGTCGATG: TGAGTCGATGG
CTGATACACTA: TGATACACTAC
CTGATAGTGGC: TGATAGTGGCG
CTGATATAAAC: TGATATAAACT
CTGATCCGGCC: TGATCCGGCCC
CTGATCTGGCC: TGATCTGGCCG
CTGATGCGAAA: TGATGCGAAAA
CTGCACCCGAA: TGCACCCGAAA
CTGCCACATGT: TGCCACATGTG
CTGCTCCGACG: TGCTCCGACGT
CTGCTGTCAGT: TGCTGTCAGTC
CTGCTTCAGAA: TGCTTCAGAAC
CTGGACGTGAC: TGGACGTGACC
CTGGAGTCCTT: TGGAGTCCTTG
CTGGAGTGGAG: TGGAGTGGAGG
CTGGCCATAGT: TGGCCATAGTA
CTGGCCGTTAT: TGGCCGTTATG
CTGGCTAAGTG: TGGCTAAGTGC
CTGGCTGGTGA: TGGCTGGTGAA
CTGGCTTGCTT: TGGCTTGCTTC
CTGGGGAGCTG: TGGGGAGCTGA
CTGGGGGACAC: TGGGGGACACA
CTGGGGGAGGC: TGGGGGAGGCA
CTGGTCACTCG: TGGTCACTCGG
CTGGTGAATAG: TGGTGAATAGC
CTGGTTATGTT: TGGTTATGTTT
CTGTAAGCACA: TGTAAGCACAG
CTGTATCTCAA: TGTATCTCAAT
CTGTATGTCTG: TGTATGTCTGG
CTGTCAGTCGT: TGTCAGTCGTC
CTGTCGGGCCC: TGTCGGGCCCT
CTGTCGTACTC: TGTCGTACTCT
CTGTCTTTATT: TGTCTTTATTA
CTGTTCGGGTC: TGTTCGGGTCA
CTTAAAGGGTT: TTAAAGGGTTC
CTTAACATTTT: TTAACATTTTG
CTTAGCCGATT: TTAGCCGATTA
CTTAGGTCCAG: TTAGGTCCAGC
CTTAGTTGGTA: TTAGTTGGTAC
CTTATCTTGAC: TTATCTTGACC
CTTCACTGATA: TTCACTGATAG
CTTCAGAACGT: TTCAGAACGTG
CTTCAGAAGGT: TTCAGAAGGTC
CTTCCCCTCTA: TTCCCCTCTAT
CTTCGCTCACA: TTCGCTCACAG
CTTCGGACCGC: TTCGGACCGCG
CTTCGGGTCGA: TTCGGGTCGAA
CTTCTTAAAGG: TTCTTAAAGGG
CTTGACCTCTC: TTGACCTCTCG
CTTGAGATGAT: TTGAGATGATT
CTTGAGGCAGT: TTGAGGCAGTT
CTTGCCGGGAA: TTGCCGGGAAC
CTTGCTTCAGA: TTGCTTCAGAA
CTTGGACATAA: TTGGACATAAC
CTTGGGCCGAC: TTGGGCCGACT
CTTGTGAGTCT: TTGTGAGTCTA
CTTTAAGTCGA: TTTAAGTCGAA
CTTTACAGCAA: TTTACAGCAAC
CTTTATTAATG: TTTATTAATGG
CTTTCACTACG: TTTCACTACGC
CTTTCATGGTT: TTTCATGGTTC
CTTTGAGCCGG: TTTGAGCCGGC
CTTTTCGCGTA: TTTTCGCGTAA
GAAAAACTCAG: AAAAACTCAGT
GAAAACAAGTA: AAAACAAGTAC
GAAAATCGCGA: AAAATCGCGAT
GAAAATCGCGG: AAAATCGCGGT
GAAACTAACCT: AAACTAACCTC
GAAAGCGCATT: AAAGCGCATTC
GAAATACTCTT: AAATACTCTTC
GAAATCAGAAA: AAATCAGAAAC
GAACCCTGAGG: AACCCTGAGGT
GAACCGACCTA: AACCGACCTAT
GAACCGTTTTG: AACCGTTTTGT
GAACGTGACGA: AACGTGACGAG
GAACTATGGAA: AACTATGGAAT
GAACTCAGAGC: AACTCAGAGCC
GAACTTAGTTG: AACTTAGTTGG
GAAGGGCTGGG: AAGGGCTGGGG
GAAGGTCACAA: AAGGTCACAAT
GAAGTGTCTAA: AAGTGTCTAAA
GAATAGCCTCG: AATAGCCTCGC
GAATCATACTC: AATCATACTCA
GAATCCCATGT: AATCCCATGTA
GAATCTGAAAA: AATCTGAAAAT
GAATTTGATAA: AATTTGATAAG
GACACAGATAT: ACACAGATATC
GACACCTACCA: ACACCTACCAC
GACAGAGTGGG: ACAGAGTGGGG
GACAGCCCCGA: ACAGCCCCGAT
GACAGCCGCGA: ACAGCCGCGAA
GACATAACCGA: ACATAACCGAA
GACATCCCAAA: ACATCCCAAAT
GACATCTCGAC: ACATCTCGACT
GACCAAGCGGG: ACCAAGCGGGA
GACCACGAGTT: ACCACGAGTTG
GACCACGTAAC: ACCACGTAACC
GACCCAGGTGA: ACCCAGGTGAT
GACCCCGACCA: ACCCCGACCAC
GACCCTATCTC: ACCCTATCTCT
GACCGCGCGTT: ACCGCGCGTTA
GACCGCGTGGT: ACCGCGTGGTG
GACCGTATAAC: ACCGTATAACT
GACCTATGGCC: ACCTATGGCCC
GACCTCTCGTC: ACCTCTCGTCC
GACCTGTTCGG: ACCTGTTCGGG
GACGACAGAGT: ACGACAGAGTG
GACGACATCCC: ACGACATCCCA
GACGACCCTAT: ACGACCCTATC
GACGACGACGT: ACGACGACGTG
GACGACGTGAT: ACGACGTGATT
GACGAGCTTTA: ACGAGCTTTAC
GACGCTATCCT: ACGCTATCCTC
GACGGAACCGA: ACGGAACCGAC
GACGGTCGGTT: ACGGTCGGTTA
GACGTAGTCGG: ACGTAGTCGGG
GACGTGACCAA: ACGTGACCAAG
GACGTGATTGC: ACGTGATTGCT
GACTAGAGTTA: ACTAGAGTTAA
GACTATAGTCT: ACTATAGTCTA
GACTCTAAAGA: ACTCTAAAGAT
GACTGCTCCGA: ACTGCTCCGAC
GACTGGAGTCC: ACTGGAGTCCT
GAGAACCGTTT: AGAACCGTTTT
GAGAGTTAGTC: AGAGTTAGTCA
GAGAGTTTCGG: AGAGTTTCGGG
GAGATGATTCT: AGATGATTCTC
GAGATGTCTTA: AGATGTCTTAG
GAGATTAACAC: AGATTAACACG
GAGCACTGATC: AGCACTGATCT
GAGCCATACAG: AGCCATACAGG
GAGCCGGCGTG: AGCCGGCGTGT
GAGCTGACGCT: AGCTGACGCTA
GAGCTTTACAG: AGCTTTACAGC
GAGGCAACGTT: AGGCAACGTTG
GAGGCAGTTAA: AGGCAGTTAAA
GAGGCCCCTTT: AGGCCCCTTTC
GAGGGCGACCG: AGGGCGACCGT
GAGGGGTGATG: AGGGGTGATGG
GAGGTAACGGT: AGGTAACGGTA
GAGGTTCCCGA: AGGTTCCCGAC
GAGTAATGAGC: AGTAATGAGCA
GAGTCCTTGGG: AGTCCTTGGGC
GAGTCGATGGT: AGTCGATGGTA
GAGTGGAGGGC: AGTGGAGGGCG
GAGTGGGGTGT: AGTGGGGTGTC
GAGTTAACTGG: AGTTAACTGGA
GAGTTAGTCAT: AGTTAGTCATG
GAGTTGAATCA: AGTTGAATCAT
GAGTTGTTATA: AGTTGTTATAT
GAGTTTCGGGG: AGTTTCGGGGT
GATAAGCGTTT: ATAAGCGTTTC
GATACACTACT: ATACACTACTT
GATAGCATAGC: ATAGCATAGCT
GATAGTGGCGG: ATAGTGGCGGC
GATAGTTCCGG: ATAGTTCCGGC
GATATAAACTA: ATATAAACTAA
GATATATGGCG: ATATATGGCGT
GATATCATGCA: ATATCATGCAG
GATCCGGCCCA: ATCCGGCCCAC
GATCGACCGCG: ATCGACCGCGC
GATCTAACGCA: ATCTAACGCAC
GATCTGAGTCG: ATCTGAGTCGA
GATCTGGCCGT: ATCTGGCCGTT
GATGATTCTCA: ATGATTCTCAA
GATGCGAAAAC: ATGCGAAAACA
GATGGCTCCCT: ATGGCTCCCTA
GATGGTATATC: ATGGTATATCC
GATGGTGCAAC: ATGGTGCAACT
GATGTACGCGA: ATGTACGCGAC
GATGTCTTAGG: ATGTCTTAGGT
GATGTTAGCTT: ATGTTAGCTTG
GATTAAATTGG: ATTAAATTGGG
GATTAACACGT: ATTAACACGTC
GATTAAGCGAG: ATTAAGCGAGG
GATTACTAAAC: ATTACTAAACG
GATTAGGGTAA: ATTAGGGTAAT
GATTCAGCTTG: ATTCAGCTTGC
GATTCTCAACC: ATTCTCAACCG
GATTGAGTTGA: ATTGAGTTGAA
GATTGCTTGGA: ATTGCTTGGAC
GCAAAACGAGA: CAAAACGAGAG
GCAAACTACAC: CAAACTACACT
GCAACAGTCCA: CAACAGTCCAT
GCAACCACATC: CAACCACATCG
GCAACGTTCGA: CAACGTTCGAA
GCAACGTTGTC: CAACGTTGTCG
GCAACTGGGGG: CAACTGGGGGA
GCAAGCTAAAC: CAAGCTAAACT
GCAATACCCCG: CAATACCCCGT
GCAATCTGATA: CAATCTGATAC
GCAATGGGTAG: CAATGGGTAGC
GCACAAACCCA: CACAAACCCAA
GCACACAAAAC: CACACAAAACC
GCACAGCGATT: CACAGCGATTG
GCACAGCGGTT: CACAGCGGTTA
GCACATCAGAG: CACATCAGAGA
GCACCCGAAAA: CACCCGAAAAA
GCACCTTTTCG: CACCTTTTCGC
GCACTCATCCA: CACTCATCCAT
GCACTGATCTG: CACTGATCTGG
GCACTTGAGAT: CACTTGAGATG
GCAGAACCCTG: CAGAACCCTGA
GCAGACTCTAA: CAGACTCTAAA
GCAGATTAAGC: CAGATTAAGCG
GCAGCATTTGT: CAGCATTTGTA
GCAGTATCAGT: CAGTATCAGTC
GCAGTTAAAAC: CAGTTAAAACC
GCAGTTAGGGC: CAGTTAGGGCA
GCATAGAAAGC: CATAGAAAGCG
GCATAGCTGCT: CATAGCTGCTG
GCATATCGGCG: CATATCGGCGG
GCATATTCATG: CATATTCATGG
GCATCAATAGG: CATCAATAGGG
GCATTCATTCG: CATTCATTCGG
GCATTTGTACT: CATTTGTACTA
GCCAATTACAA: CCAATTACAAC
GCCACATGTGG: CCACATGTGGC
GCCATACAGGC: CCATACAGGCT
GCCATAGTAGA: CCATAGTAGAC
GCCATCGGCTG: CCATCGGCTGG
GCCCACAACCT: CCCACAACCTA
GCCCCGATCGA: CCCCGATCGAC
GCCCCGTACTT: CCCCGTACTTT
GCCCCTGGTTA: CCCCTGGTTAT
GCCCCTTTCAT: CCCCTTTCATG
GCCCGGTGGAC: CCCGGTGGACT
GCCCTATCCGT: CCCTATCCGTG
GCCCTCGTAAC: CCCTCGTAACG
GCCCTGGCCAT: CCCTGGCCATA
GCCGACTAGAG: CCGACTAGAGT
GCCGATTAGGG: CCGATTAGGGT
GCCGCGAACTC: CCGCGAACTCA
GCCGCTTCCCC: CCGCTTCCCCT
GCCGGCGTGTC: CCGGCGTGTCG
GCCGGGAACTA: CCGGGAACTAT
GCCGTCAGGCT: CCGTCAGGCTT
GCCGTTATGAC: CCGTTATGACA
GCCTAGCACTC: CCTAGCACTCA
GCCTCGCTGTC: CCTCGCTGTCG
GCCTGGCTGGT: CCTGGCTGGTG
GCGAAAACAAG: CGAAAACAAGT
GCGAACTCAGA: CGAACTCAGAG
GCGACCGTATA: CGACCGTATAA
GCGACGACGAC: CGACGACGACG
GCGAGAACCGT: CGAGAACCGTT
GCGAGGCCCCT: CGAGGCCCCTT
GCGATTCAGCT: CGATTCAGCTT
GCGATTGAGTT: CGATTGAGTTG
GCGCAATGGGT: CGCAATGGGTA
GCGCACCTTTT: CGCACCTTTTC
GCGCATTCATT: CGCATTCATTC
GCGCGTTAGCT: CGCGTTAGCTA
GCGGACCACGA: CGGACCACGAG
GCGGCACAAAC: CGGCACAAACC
GCGGCACAGCG: CGGCACAGCGG
GCGGGACAGCC: CGGGACAGCCC
GCGGGGCCCTA: CGGGGCCCTAT
GCGGGTGGCGT: CGGGTGGCGTG
GCGGTTAATAG: CGGTTAATAGA
GCGGTTGCACT: CGGTTGCACTT
GCGTAAATCAC: CGTAAATCACC
GCGTGAAGGGC: CGTGAAGGGCT
GCGTGGTGTAG: CGTGGTGTAGC
GCGTGTCGAGA: CGTGTCGAGAT
GCGTTAGCTAT: CGTTAGCTATT
GCGTTATCACG: CGTTATCACGC
GCGTTTCTGTA: CGTTTCTGTAA
GCTAAACTAGT: CTAAACTAGTA
GCTAAATATCG: CTAAATATCGG
GCTAAGTGCAG: CTAAGTGCAGA
GCTACCCAACT: CTACCCAACTT
GCTAGCAAAAC: CTAGCAAAACG
GCTATCCTCGC: CTATCCTCGCG
GCTATTACTAG: CTATTACTAGC
GCTATTGCATA: CTATTGCATAG
GCTCACAGGGC: CTCACAGGGCA
GCTCCCTAAGG: CTCCCTAAGGT
GCTCCGACGTA: CTCCGACGTAG
GCTCTTCTTAA: CTCTTCTTAAA
GCTGACGCTAT: CTGACGCTATC
GCTGATGCGAA: CTGATGCGAAA
GCTGCCACATG: CTGCCACATGT
GCTGCTGTCAG: CTGCTGTCAGT
GCTGGCTAAGT: CTGGCTAAGTG
GCTGGGGAGCT: CTGGGGAGCTG
GCTGGTGAATA: CTGGTGAATAG
GCTGTATCTCA: CTGTATCTCAA
GCTGTCAGTCG: CTGTCAGTCGT
GCTGTCGGGCC: CTGTCGGGCCC
GCTTAACATTT: CTTAACATTTT
GCTTCAGAACG: CTTCAGAACGT
GCTTCAGAAGG: CTTCAGAAGGT
GCTTCCCCTCT: CTTCCCCTCTA
GCTTCGGACCG: CTTCGGACCGC
GCTTCGGGTCG: CTTCGGGTCGA
GCTTGAGGCAG: CTTGAGGCAGT
GCTTGCCGGGA: CTTGCCGGGAA
GCTTGCTTCAG: CTTGCTTCAGA
GCTTGGACATA: CTTGGACATAA
GCTTTACAGCA: CTTTACAGCAA
GCTTTCACTAC: CTTTCACTACG
GGAAAATCGCG: GAAAATCGCGG
GGAACCGACCT: GAACCGACCTA
GGAACTATGGA: GAACTATGGAA
GGAATCCCATG: GAATCCCATGT
GGACACAGATA: GACACAGATAT
GGACAGCCCCG: GACAGCCCCGA
GGACATAACCG: GACATAACCGA
GGACCACGAGT: GACCACGAGTT
GGACCCAGGTG: GACCCAGGTGA
GGACCGCGTGG: GACCGCGTGGT
GGACCTGTTCG: GACCTGTTCGG
GGACGACCCTA: GACGACCCTAT
GGACGGAACCG: GACGGAACCGA
GGACGTGACCA: GACGTGACCAA
GGACTGGAGTC: GACTGGAGTCC
GGAGATGTCTT: GAGATGTCTTA
GGAGCTGACGC: GAGCTGACGCT
GGAGGCAACGT: GAGGCAACGTT
GGAGGGCGACC: GAGGGCGACCG
GGAGTCCTTGG: GAGTCCTTGGG
GGAGTGGAGGG: GAGTGGAGGGC
GGATAGCATAG: GATAGCATAGC
GGATCTAACGC: GATCTAACGCA
GGCAAACTACA: GCAAACTACAC
GGCAACGTTGT: GCAACGTTGTC
GGCACAAACCC: GCACAAACCCA
GGCACAGCGGT: GCACAGCGGTT
GGCAGAACCCT: GCAGAACCCTG
GGCAGTTAAAA: GCAGTTAAAAC
GGCATATCGGC: GCATATCGGCG
GGCCATAGTAG: GCCATAGTAGA
GGCCATCGGCT: GCCATCGGCTG
GGCCCACAACC: GCCCACAACCT
GGCCCCTTTCA: GCCCCTTTCAT
GGCCCTATCCG: GCCCTATCCGT
GGCCCTCGTAA: GCCCTCGTAAC
GGCCCTGGCCA: GCCCTGGCCAT
GGCCGACTAGA: GCCGACTAGAG
GGCCGCTTCCC: GCCGCTTCCCC
GGCCGTTATGA: GCCGTTATGAC
GGCGACCGTAT: GCGACCGTATA
GGCGGCACAAA: GCGGCACAAAC
GGCGGCACAGC: GCGGCACAGCG
GGCGGGTGGCG: GCGGGTGGCGT
GGCGTGAAGGG: GCGTGAAGGGC
GGCGTGTCGAG: GCGTGTCGAGA
GGCGTTATCAC: GCGTTATCACG
GGCTAAGTGCA: GCTAAGTGCAG
GGCTAGCAAAA: GCTAGCAAAAC
GGCTCCCTAAG: GCTCCCTAAGG
GGCTCTTCTTA: GCTCTTCTTAA
GGCTGGCTAAG: GCTGGCTAAGT
GGCTGGGGAGC: GCTGGGGAGCT
GGCTGGTGAAT: GCTGGTGAATA
GGCTGTATCTC: GCTGTATCTCA
GGCTTAACATT: GCTTAACATTT
GGCTTCGGACC: GCTTCGGACCG
GGCTTCGGGTC: GCTTCGGGTCG
GGCTTGCTTCA: GCTTGCTTCAG
GGGAAAATCGC: GGAAAATCGCG
GGGAACTATGG: GGAACTATGGA
GGGACACAGAT: GGACACAGATA
GGGACAGCCCC: GGACAGCCCCG
GGGACGGAACC: GGACGGAACCG
GGGAGCTGACG: GGAGCTGACGC
GGGAGGCAACG: GGAGGCAACGT
GGGCAAACTAC: GGCAAACTACA
GGGCAGAACCC: GGCAGAACCCT
GGGCATATCGG: GGCATATCGGC
GGGCCCTATCC: GGCCCTATCCG
GGGCCCTCGTA: GGCCCTCGTAA
GGGCCGACTAG: GGCCGACTAGA
GGGCGACCGTA: GGCGACCGTAT
GGGCTCTTCTT: GGCTCTTCTTA
GGGCTGGGGAG: GGCTGGGGAGC
GGGGACACAGA: GGGACACAGAT
GGGGAGCTGAC: GGGAGCTGACG
GGGGAGGCAAC: GGGAGGCAACG
GGGGCCCTATC: GGGCCCTATCC
GGGGGACACAG: GGGGACACAGA
GGGGGAGGCAA: GGGGAGGCAAC
GGGGTATCCTA: GGGTATCCTAA
GGGGTCTAGTT: GGGTCTAGTTT
GGGGTGATGGC: GGGTGATGGCT
GGGGTGTCTTA: GGGTGTCTTAG
GGGTAATTTGC: GGTAATTTGCA
GGGTACGGATC: GGTACGGATCT
GGGTAGCTAAA: GGTAGCTAAAT
GGGTATCCTAA: GGTATCCTAAG
GGGTCACTGTC: GGTCACTGTCG
GGGTCGAATTT: GGTCGAATTTG
GGGTCTAGTTT: GGTCTAGTTTT
GGGTGATGGCT: GGTGATGGCTC
GGGTGGCGTGA: GGTGGCGTGAA
GGGTGTCTTAG: GGTGTCTTAGC
GGGTTCCGGCT: GGTTCCGGCTA
GGTAACGGTAG: GTAACGGTAGC
GGTAATTTGCA: GTAATTTGCAA
GGTACGGATCT: GTACGGATCTA
GGTACGTCCAA: GTACGTCCAAT
GGTAGCATCAA: GTAGCATCAAT
GGTAGCTAAAT: GTAGCTAAATA
GGTATATCCGC: GTATATCCGCG
GGTATCCTAAG: GTATCCTAAGC
GGTCACAATGC: GTCACAATGCC
GGTCACTCGGA: GTCACTCGGAG
GGTCACTGTCG: GTCACTGTCGT
GGTCCAGCCCC: GTCCAGCCCCT
GGTCCCGATTA: GTCCCGATTAC
GGTCGAATTTG: GTCGAATTTGA
GGTCGGTTATC: GTCGGTTATCT
GGTCTAGTTTT: GTCTAGTTTTC
GGTGAATAGCC: GTGAATAGCCT
GGTGATGGCTC: GTGATGGCTCC
GGTGATGGTGC: GTGATGGTGCA
GGTGCAACTGG: GTGCAACTGGG
GGTGGACCTGT: GTGGACCTGTT
GGTGGACTGGA: GTGGACTGGAG
GGTGGCGTGAA: GTGGCGTGAAG
GGTGGTTCGAT: GTGGTTCGATA
GGTGTAGCTTT: GTGTAGCTTTC
GGTGTCTTAGC: GTGTCTTAGCC
GGTTAATAGAG: GTTAATAGAGG
GGTTATCTTGT: GTTATCTTGTG
GGTTATGTTTT: GTTATGTTTTT
GGTTCCCGACG: GTTCCCGACGA
GGTTCCGGCTA: GTTCCGGCTAG
GGTTCGATATA: GTTCGATATAT
GGTTCGCGCAA: GTTCGCGCAAT
GGTTGCACTTG: GTTGCACTTGA
GTAAATCACCC: TAAATCACCCC
GTAACCCGACA: TAACCCGACAT
GTAACGGTAGC: TAACGGTAGCA
GTAACGTCCAT: TAACGTCCATT
GTAACGTTGGT: TAACGTTGGTG
GTAAGCACAGC: TAAGCACAGCG
GTAATGAGCAC: TAATGAGCACT
GTAATTTGCAA: TAATTTGCAAC
GTACCCGAGGT: TACCCGAGGTA
GTACCGCCTAG: TACCGCCTAGC
GTACGCGACGA: TACGCGACGAC
GTACGGATCTA: TACGGATCTAA
GTACGTCCAAT: TACGTCCAATC
GTACTATGATC: TACTATGATCT
GTACTCTTCAC: TACTCTTCACT
GTACTTTAAGT: TACTTTAAGTC
GTAGAACTTAG: TAGAACTTAGT
GTAGACGGTCG: TAGACGGTCGG
GTAGCATCAAT: TAGCATCAATA
GTAGCTAAATA: TAGCTAAATAT
GTAGCTTTCAC: TAGCTTTCACT
GTAGTCGGGCA: TAGTCGGGCAA
GTATAACTGGA: TATAACTGGAC
GTATATCCGCG: TATATCCGCGG
GTATCAGTCCG: TATCAGTCCGA
GTATCCTAAGC: TATCCTAAGCC
GTATCTCAATG: TATCTCAATGC
GTATCTGGCTT: TATCTGGCTTG
GTATGTCTGGG: TATGTCTGGGG
GTCACAATGCC: TCACAATGCCC
GTCACTCGGAG: TCACTCGGAGA
GTCACTGTCGT: TCACTGTCGTA
GTCAGGCTTCG: TCAGGCTTCGG
GTCAGTCGTCC: TCAGTCGTCCA
GTCATCTGCAC: TCATCTGCACC
GTCATGGGTAC: TCATGGGTACG
GTCATTCAGGC: TCATTCAGGCC
GTCCAATCAAG: TCCAATCAAGC
GTCCAGCCCCT: TCCAGCCCCTG
GTCCATAAGCG: TCCATAAGCGG
GTCCATGATGT: TCCATGATGTA
GTCCATTAGGG: TCCATTAGGGG
GTCCATTCACG: TCCATTCACGA
GTCCCCGCACA: TCCCCGCACAT
GTCCCGATTAC: TCCCGATTACT
GTCCGATAGTT: TCCGATAGTTC
GTCCTGATATA: TCCTGATATAA
GTCCTGCTTCA: TCCTGCTTCAG
GTCCTTGGGCC: TCCTTGGGCCG
GTCGAAATACT: TCGAAATACTC
GTCGAATTTGA: TCGAATTTGAT
GTCGAGATTAA: TCGAGATTAAC
GTCGATGGTAT: TCGATGGTATA
GTCGCTGCCAC: TCGCTGCCACA
GTCGGGCAAAC: TCGGGCAAACT
GTCGGGCCCTC: TCGGGCCCTCG
GTCGGTTATCT: TCGGTTATCTT
GTCGTACTCTT: TCGTACTCTTC
GTCGTCCATTC: TCGTCCATTCA
GTCTAAATATG: TCTAAATATGA
GTCTAGTTTTC: TCTAGTTTTCA
GTCTATTAAAA: TCTATTAAAAC
GTCTGGGGGAC: TCTGGGGGACA
GTCTTAGCCGA: TCTTAGCCGAT
GTCTTAGGTCC: TCTTAGGTCCA
GTCTTTATTAA: TCTTTATTAAT
GTGAAGGGCTG: TGAAGGGCTGG
GTGAATAGCCT: TGAATAGCCTC
GTGACCAAGCG: TGACCAAGCGG
GTGACGAGCTT: TGACGAGCTTT
GTGACTGCTCC: TGACTGCTCCG
GTGAGTCTACA: TGAGTCTACAT
GTGATGGCTCC: TGATGGCTCCC
GTGATGGTGCA: TGATGGTGCAA
GTGATTGCTTG: TGATTGCTTGG
GTGCAACTGGG: TGCAACTGGGG
GTGCAGATTAA: TGCAGATTAAG
GTGCATATTCA: TGCATATTCAT
GTGGACCTGTT: TGGACCTGTTC
GTGGACTGGAG: TGGACTGGAGT
GTGGAGGGCGA: TGGAGGGCGAC
GTGGCGGCACA: TGGCGGCACAG TGGCGGCACAA
GTGGCGTGAAG: TGGCGTGAAGG
GTGGGGTGTCT: TGGGGTGTCTT
GTGGTGTAGCT: TGGTGTAGCTT
GTGGTTCGATA: TGGTTCGATAT
GTGTAGCTTTC: TGTAGCTTTCA
GTGTCGAGATT: TGTCGAGATTA
GTGTCTAAATA: TGTCTAAATAT
GTGTCTTAGCC: TGTCTTAGCCG
GTTAAAACCGC: TTAAAACCGCT
GTTAACTGGAG: TTAACTGGAGT
GTTAATAGAGG: TTAATAGAGGG
GTTAGCTATTG: TTAGCTATTGC
GTTAGCTTGAG: TTAGCTTGAGG
GTTAGGGCATA: TTAGGGCATAT
GTTAGTCATGG: TTAGTCATGGG
GTTATATTTGG: TTATATTTGGA
GTTATCACGCA: TTATCACGCAA
GTTATCTTGTG: TTATCTTGTGA
GTTATGACACC: TTATGACACCT
GTTATGTTTTT: TTATGTTTTTC
GTTATTGCAGT: TTATTGCAGTA
GTTCCCGACGA: TTCCCGACGAC
GTTCCGGCTAG: TTCCGGCTAGC
GTTCCGGCTTC: TTCCGGCTTCG
GTTCCTGATCC: TTCCTGATCCG
GTTCGAAATCA: TTCGAAATCAG
GTTCGATATAT: TTCGATATATG
GTTCGCGCAAT: TTCGCGCAATG
GTTCGGGTCAC: TTCGGGTCACT
GTTGAATCATA: TTGAATCATAC
GTTGCACTTGA: TTGCACTTGAG
GTTGGTACGTC: TTGGTACGTCC
GTTGGTGGTTC: TTGGTGGTTCG
GTTGTCGCTGC: TTGTCGCTGCC
GTTGTTATATT: TTGTTATATTT
GTTTCGGGGTC: TTTCGGGGTCT
GTTTCTGTAAG: TTTCTGTAAGC
GTTTTCATGCA: TTTTCATGCAG
GTTTTGTCCTG: TTTTGTCCTGA
GTTTTTCGTTC: TTTTTCGTTCC
TAAAACCGCTA: AAAACCGCTAC
TAAAACTGTAT: AAAACTGTATG
TAAACGTAACG: AAACGTAACGT
TAAACTAAGGC: AAACTAAGGCT
TAAACTAGTAT: AAACTAGTATC
TAAAGAATCTG: AAAGAATCTGA
TAAAGATTAAA: AAAGATTAAAT
TAAAGGGTTCC: AAAGGGTTCCG
TAAATATCGGG: AAATATCGGGC
TAAATATGAGT: AAATATGAGTA
TAAATCACCCC: AAATCACCCCA
TAAATTGGGAA: AAATTGGGAAA
TAACACGTCCC: AACACGTCCCC
TAACATTTTGC: AACATTTTGCC
TAACCCGACAT: AACCCGACATC
TAACCGAAGTG: AACCGAAGTGT
TAACCTCCGAC: AACCTCCGACA
TAACGCACACA: AACGCACACAA
TAACGGTAGCA: AACGGTAGCAT
TAACGTCCATT: AACGTCCATTA
TAACGTTGGTG: AACGTTGGTGG
TAACTGGACGT: AACTGGACGTG
TAACTGGAGTG: AACTGGAGTGG
TAAGCACAGCG: AAGCACAGCGA
TAAGCCGTCAG: AAGCCGTCAGG
TAAGCGAGGCC: AAGCGAGGCCC
TAAGCGGGGCC: AAGCGGGGCCC
TAAGCGTTTCT: AAGCGTTTCTG
TAAGGCTGTAT: AAGGCTGTATC
TAAGGTGGACC: AAGGTGGACCT
TAAGTCGAAAT: AAGTCGAAATA
TAAGTGCAGAT: AAGTGCAGATT
TAATAGAGGGG: AATAGAGGGGT
TAATATTTCAG: AATATTTCAGC
TAATGAGCACT: AATGAGCACTG
TAATGGACCCA: AATGGACCCAG
TAATTTGCAAC: AATTTGCAACC
TACAACCTGTC: ACAACCTGTCT
TACACTACTTT: ACACTACTTTG
TACACTGGTCA: ACACTGGTCAC
TACAGCAACGT: ACAGCAACGTT
TACAGGCTTAA: ACAGGCTTAAC
TACCACGTGCA: ACCACGTGCAT
TACCCAACTTA: ACCCAACTTAT
TACCCCGTCAT: ACCCCGTCATC
TACCCGAGGTA: ACCCGAGGTAA
TACCGCCTAGC: ACCGCCTAGCA
TACGCGACGAC: ACGCGACGACG
TACGCGAGAAC: ACGCGAGAACC
TACGGATCTAA: ACGGATCTAAC
TACGTCCAATC: ACGTCCAATCA
TACTAAACGTA: ACTAAACGTAA
TACTAGCAATC: ACTAGCAATCT
TACTATGATCT: ACTATGATCTG
TACTCAATTTG: ACTCAATTTGT
TACTCTTCACT: ACTCTTCACTG
TACTCTTCGCT: ACTCTTCGCTC
TACTTTAAGTC: ACTTTAAGTCG
TACTTTGAGCC: ACTTTGAGCCG
TAGAAAGCGCA: AGAAAGCGCAT
TAGAACTTAGT: AGAACTTAGTT
TAGACGGTCGG: AGACGGTCGGT
TAGAGGGGTGA: AGAGGGGTGAT
TAGAGTTAACT: AGAGTTAACTG
TAGCAAAACGA: AGCAAAACGAG
TAGCAATCTGA: AGCAATCTGAT
TAGCACTCATC: AGCACTCATCC
TAGCATAGCTG: AGCATAGCTGC
TAGCATCAATA: AGCATCAATAG
TAGCCGATTAG: AGCCGATTAGG
TAGCCTCGCTG: AGCCTCGCTGT
TAGCTAAATAT: AGCTAAATATC
TAGCTATTGCA: AGCTATTGCAT
TAGCTGCTGTC: AGCTGCTGTCA
TAGCTTGAGGC: AGCTTGAGGCA
TAGCTTTCACT: AGCTTTCACTA
TAGGGACGGAA: AGGGACGGAAC
TAGGGCATATC: AGGGCATATCG
TAGGGGTATCC: AGGGGTATCCT
TAGGGTAATTT: AGGGTAATTTG
TAGGTCCAGCC: AGGTCCAGCCC
TAGTAGACGGT: AGTAGACGGTC
TAGTATCTGGC: AGTATCTGGCT
TAGTCATGGGT: AGTCATGGGTA
TAGTCGGGCAA: AGTCGGGCAAA
TAGTCTATTAA: AGTCTATTAAA
TAGTGGCGGCA: AGTGGCGGCAC
TAGTTCCGGCT: AGTTCCGGCTT
TAGTTGGTACG: AGTTGGTACGT
TAGTTTTCATG: AGTTTTCATGC
TATAAACTAAG: ATAAACTAAGG
TATAACTGGAC: ATAACTGGACG
TATAGTCTATT: ATAGTCTATTA
TATATCCGCGG: ATATCCGCGGA
TATATGGCGTT: ATATGGCGTTA
TATATTTGGAC: ATATTTGGACG
TATCACGCAAT: ATCACGCAATA
TATCAGTCCGA: ATCAGTCCGAT
TATCATGCAGC: ATCATGCAGCA
TATCCGCGGAC: ATCCGCGGACC
TATCCGTGACT: ATCCGTGACTG
TATCCTAAGCC: ATCCTAAGCCG
TATCCTCGCGC: ATCCTCGCGCA
TATCGGCGGGT: ATCGGCGGGTG
TATCGGGCTCT: ATCGGGCTCTT
TATCTCAATGC: ATCTCAATGCT
TATCTCTAATA: ATCTCTAATAT
TATCTGGCTTG: ATCTGGCTTGC
TATCTTGACCT: ATCTTGACCTC
TATCTTGTGAG: ATCTTGTGAGT
TATGACACCTA: ATGACACCTAC
TATGAGTAATG: ATGAGTAATGA
TATGATCTGAG: ATGATCTGAGT
TATGCCAATTA: ATGCCAATTAC
TATGCCCCGTA: ATGCCCCGTAC
TATGGAATCCC: ATGGAATCCCA
TATGGCCCTGG: ATGGCCCTGGC
TATGGCGTTAT: ATGGCGTTATC
TATGTCTGGGG: ATGTCTGGGGG
TATGTTTTTCG: ATGTTTTTCGT
TATTAAAACTG: ATTAAAACTGT
TATTAATGGAC: ATTAATGGACC
TATTACTAGCA: ATTACTAGCAA
TATTCATGGAT: ATTCATGGATA
TATTGCAGTAT: ATTGCAGTATC
TATTGCATAGA: ATTGCATAGAA
TATTTCAGCAA: ATTTCAGCAAG
TATTTGGACGA: ATTTGGACGAC
TCAACCGATGT: CAACCGATGTT
TCAAGCAACAG: CAAGCAACAGT
TCAATAGGGAC: CAATAGGGACG
TCAATGCTATT: CAATGCTATTA
TCAATTTGTCA: CAATTTGTCAT
TCACAATGCCC: CACAATGCCCG
TCACAGGGCAG: CACAGGGCAGA
TCACCCCATGC: CACCCCATGCT
TCACGACGACA: CACGACGACAT
TCACGCAATAC: CACGCAATACC
TCACTACGCGA: CACTACGCGAG
TCACTCGGAGA: CACTCGGAGAT
TCACTGATAGT: CACTGATAGTG
TCACTGTCGTA: CACTGTCGTAC
TCAGAAACTAA: CAGAAACTAAC
TCAGAACGTGA: CAGAACGTGAC
TCAGAAGGTCA: CAGAAGGTCAC
TCAGAGAGTTT: CAGAGAGTTTC
TCAGAGCCATA: CAGAGCCATAC
TCAGCAAGCTA: CAGCAAGCTAA
TCAGCTTGCCG: CAGCTTGCCGG
TCAGGCCGCTT: CAGGCCGCTTC
TCAGGCTTCGG: CAGGCTTCGGG
TCAGTCCGATA: CAGTCCGATAG
TCAGTCGTCCA: CAGTCGTCCAT
TCAGTTATTGC: CAGTTATTGCA
TCATACTCAAT: CATACTCAATT
TCATATGCCCC: CATATGCCCCG
TCATCCATGCA: CATCCATGCAG
TCATCTGCACC: CATCTGCACCC
TCATGCAGCAT: CATGCAGCATT
TCATGCAGTTA: CATGCAGTTAG
TCATGGATAGC: CATGGATAGCA
TCATGGGTACG: CATGGGTACGG
TCATGGTTCGC: CATGGTTCGCG
TCATTCAGGCC: CATTCAGGCCG
TCATTCGGTCC: CATTCGGTCCC
TCCAATCAAGC: CCAATCAAGCA
TCCAGCCCCTG: CCAGCCCCTGG
TCCATAAGCGG: CCATAAGCGGG
TCCATGATGTA: CCATGATGTAC
TCCATGCAGAC: CCATGCAGACT
TCCATTAGGGG: CCATTAGGGGT
TCCATTCACGA: CCATTCACGAC
TCCCAAATGGC: CCCAAATGGCC
TCCCATGTACC: CCCATGTACCG
TCCCCGCACAT: CCCCGCACATC
TCCCCTCTATG: CCCCTCTATGC
TCCCGACGACA: CCCGACGACAG
TCCCGATTACT: CCCGATTACTA
TCCCTAAGGTG: CCCTAAGGTGG
TCCGACAGCCG: CCGACAGCCGC
TCCGACCCCGA: CCGACCCCGAC
TCCGACGTAGT: CCGACGTAGTC
TCCGATAGTTC: CCGATAGTTCC
TCCGCGGACCA: CCGCGGACCAC
TCCGGCCCACA: CCGGCCCACAA
TCCGGCTAGCA: CCGGCTAGCAA
TCCGGCTTCGG: CCGGCTTCGGA
TCCGTGACTGC: CCGTGACTGCT
TCCTAAGCCGT: CCTAAGCCGTC
TCCTCGCGCAC: CCTCGCGCACC
TCCTGATATAA: CCTGATATAAA
TCCTGATCCGG: CCTGATCCGGC
TCCTGCTTCAG: CCTGCTTCAGA
TCCTTGGGCCG: CCTTGGGCCGA
TCGAAATACTC: CGAAATACTCT
TCGAAATCAGA: CGAAATCAGAA
TCGAATTTGAT: CGAATTTGATA
TCGACCGCGCG: CGACCGCGCGT
TCGACTATAGT: CGACTATAGTC
TCGAGATTAAC: CGAGATTAACA
TCGATATATGG: CGATATATGGC
TCGATGGTATA: CGATGGTATAT
TCGCGATTCAG: CGCGATTCAGC
TCGCGCAATGG: CGCGCAATGGG
TCGCGCACCTT: CGCGCACCTTT
TCGCGGTTGCA: CGCGGTTGCAC
TCGCGTAAATC: CGCGTAAATCA
TCGCTCACAGG: CGCTCACAGGG
TCGCTGCCACA: CGCTGCCACAT
TCGCTGTCGGG: CGCTGTCGGGC
TCGGACCGCGT: CGGACCGCGTG
TCGGAGATGTC: CGGAGATGTCT
TCGGCGGGTGG: CGGCGGGTGGC
TCGGCTGGCTA: CGGCTGGCTAA
TCGGGCAAACT: CGGGCAAACTA
TCGGGCCCTCG: CGGGCCCTCGT
TCGGGCTCTTC: CGGGCTCTTCT
TCGGGGTCTAG: CGGGGTCTAGT
TCGGGTCACTG: CGGGTCACTGT
TCGGGTCGAAT: CGGGTCGAATT
TCGGTCCCGAT: CGGTCCCGATT
TCGGTTATCTT: CGGTTATCTTG
TCGTAACGTTG: CGTAACGTTGG
TCGTACTCTTC: CGTACTCTTCA
TCGTAGAACTT: CGTAGAACTTA
TCGTCCATGAT: CGTCCATGATG
TCGTCCATTCA: CGTCCATTCAC
TCGTTCCTGAT: CGTTCCTGATC
TCTAAAGATTA: CTAAAGATTAA
TCTAAATATGA: CTAAATATGAG
TCTAACGCACA: CTAACGCACAC
TCTAATATTTC: CTAATATTTCA
TCTAGTTTTCA: CTAGTTTTCAT
TCTATGCCAAT: CTATGCCAATT
TCTATTAAAAC: CTATTAAAACT
TCTCAACCGAT: CTCAACCGATG
TCTCAATGCTA: CTCAATGCTAT
TCTCGACTATA: CTCGACTATAG
TCTCGTCCATG: CTCGTCCATGA
TCTCTAATATT: CTCTAATATTT
TCTGAAAATCG: CTGAAAATCGC
TCTGAGTCGAT: CTGAGTCGATG
TCTGATACACT: CTGATACACTA
TCTGCACCCGA: CTGCACCCGAA
TCTGGCCGTTA: CTGGCCGTTAT
TCTGGCTTGCT: CTGGCTTGCTT
TCTGGGGGACA: CTGGGGGACAC
TCTGTAAGCAC: CTGTAAGCACA
TCTTAAAGGGT: CTTAAAGGGTT
TCTTAGCCGAT: CTTAGCCGATT
TCTTAGGTCCA: CTTAGGTCCAG
TCTTCACTGAT: CTTCACTGATA
TCTTCGCTCAC: CTTCGCTCACA
TCTTCTTAAAG: CTTCTTAAAGG
TCTTGACCTCT: CTTGACCTCTC
TCTTGTGAGTC: CTTGTGAGTCT
TCTTTATTAAT: CTTTATTAATG
TGAAAATCGCG: GAAAATCGCGA
TGAAGGGCTGG: GAAGGGCTGGG
TGAATAGCCTC: GAATAGCCTCG
TGAATCATACT: GAATCATACTC
TGACACCTACC: GACACCTACCA
TGACCAAGCGG: GACCAAGCGGG
TGACCTCTCGT: GACCTCTCGTC
TGACGAGCTTT: GACGAGCTTTA
TGACGCTATCC: GACGCTATCCT
TGACTGCTCCG: GACTGCTCCGA
TGAGATGATTC: GAGATGATTCT
TGAGCACTGAT: GAGCACTGATC
TGAGCCGGCGT: GAGCCGGCGTG
TGAGGCAGTTA: GAGGCAGTTAA
TGAGGTTCCCG: GAGGTTCCCGA
TGAGTAATGAG: GAGTAATGAGC
TGAGTCGATGG: GAGTCGATGGT
TGAGTCTACAT: GAGTCTACATC
TGAGTTGAATC: GAGTTGAATCA
TGATAAGCGTT: GATAAGCGTTT
TGATACACTAC: GATACACTACT
TGATAGTGGCG: GATAGTGGCGG
TGATATAAACT: GATATAAACTA
TGATCCGGCCC: GATCCGGCCCA
TGATCTGAGTC: GATCTGAGTCG
TGATCTGGCCG: GATCTGGCCGT
TGATGCGAAAA: GATGCGAAAAC
TGATGGCTCCC: GATGGCTCCCT
TGATGGTGCAA: GATGGTGCAAC
TGATGTACGCG: GATGTACGCGA
TGATTCTCAAC: GATTCTCAACC
TGATTGCTTGG: GATTGCTTGGA
TGCAACCACAT: GCAACCACATC
TGCAACTGGGG: GCAACTGGGGG
TGCACCCGAAA: GCACCCGAAAA
TGCACTTGAGA: GCACTTGAGAT
TGCAGACTCTA: GCAGACTCTAA
TGCAGATTAAG: GCAGATTAAGC
TGCAGCATTTG: GCAGCATTTGT
TGCAGTATCAG: GCAGTATCAGT
TGCAGTTAGGG: GCAGTTAGGGC
TGCATAGAAAG: GCATAGAAAGC
TGCATATTCAT: GCATATTCATG
TGCCAATTACA: GCCAATTACAA
TGCCACATGTG: GCCACATGTGG
TGCCCCGTACT: GCCCCGTACTT
TGCCCGGTGGA: GCCCGGTGGAC
TGCCGGGAACT: GCCGGGAACTA
TGCCTGGCTGG: GCCTGGCTGGT
TGCGAAAACAA: GCGAAAACAAG
TGCTATTACTA: GCTATTACTAG
TGCTCCGACGT: GCTCCGACGTA
TGCTGATGCGA: GCTGATGCGAA
TGCTGTCAGTC: GCTGTCAGTCG
TGCTTCAGAAC: GCTTCAGAACG
TGCTTCAGAAG: GCTTCAGAAGG
TGCTTGGACAT: GCTTGGACATA
TGGAATCCCAT: GGAATCCCATG
TGGACATAACC: GGACATAACCG
TGGACCCAGGT: GGACCCAGGTG
TGGACCTGTTC: GGACCTGTTCG
TGGACGACCCT: GGACGACCCTA
TGGACGTGACC: GGACGTGACCA
TGGACTGGAGT: GGACTGGAGTC
TGGAGGGCGAC: GGAGGGCGACC
TGGAGTCCTTG: GGAGTCCTTGG
TGGAGTGGAGG: GGAGTGGAGGG
TGGATAGCATA: GGATAGCATAG
TGGCCATAGTA: GGCCATAGTAG
TGGCCATCGGC: GGCCATCGGCT
TGGCCCTGGCC: GGCCCTGGCCA
TGGCCGTTATG: GGCCGTTATGA
TGGCGGCACAA: GGCGGCACAAA
TGGCGGCACAG: GGCGGCACAGC
TGGCGTGAAGG: GGCGTGAAGGG
TGGCGTTATCA: GGCGTTATCAC
TGGCTAAGTGC: GGCTAAGTGCA
TGGCTCCCTAA: GGCTCCCTAAG
TGGCTGGTGAA: GGCTGGTGAAT
TGGCTTGCTTC: GGCTTGCTTCA
TGGGAAAATCG: GGGAAAATCGC
TGGGCCGACTA: GGGCCGACTAG
TGGGGAGCTGA: GGGGAGCTGAC
TGGGGGACACA: GGGGGACACAG
TGGGGGAGGCA: GGGGGAGGCAA
TGGGGTGTCTT: GGGGTGTCTTA
TGGGTACGGAT: GGGTACGGATC
TGGGTAGCTAA: GGGTAGCTAAA
TGGTACGTCCA: GGTACGTCCAA
TGGTATATCCG: GGTATATCCGC
TGGTCACTCGG: GGTCACTCGGA
TGGTGAATAGC: GGTGAATAGCC
TGGTGCAACTG: GGTGCAACTGG
TGGTGGTTCGA: GGTGGTTCGAT
TGGTGTAGCTT: GGTGTAGCTTT
TGGTTATGTTT: GGTTATGTTTT
TGGTTCGATAT: GGTTCGATATA
TGGTTCGCGCA: GGTTCGCGCAA
TGTAAGCACAG: GTAAGCACAGC
TGTACCGCCTA: GTACCGCCTAG
TGTACGCGACG: GTACGCGACGA
TGTACTATGAT: GTACTATGATC
TGTAGCTTTCA: GTAGCTTTCAC
TGTATCTCAAT: GTATCTCAATG
TGTATGTCTGG: GTATGTCTGGG
TGTCAGTCGTC: GTCAGTCGTCC
TGTCATTCAGG: GTCATTCAGGC
TGTCCTGATAT: GTCCTGATATA
TGTCCTGCTTC: GTCCTGCTTCA
TGTCGAGATTA: GTCGAGATTAA
TGTCGCTGCCA: GTCGCTGCCAC
TGTCGGGCCCT: GTCGGGCCCTC
TGTCGTACTCT: GTCGTACTCTT
TGTCTAAATAT: GTCTAAATATG
TGTCTGGGGGA: GTCTGGGGGAC
TGTCTTAGCCG: GTCTTAGCCGA
TGTCTTAGGTC: GTCTTAGGTCC
TGTCTTTATTA: GTCTTTATTAA
TGTGAGTCTAC: GTGAGTCTACA
TGTGGCGGCAC: GTGGCGGCACA
TGTTAGCTTGA: GTTAGCTTGAG
TGTTATATTTG: GTTATATTTGG
TGTTCGGGTCA: GTTCGGGTCAC
TGTTTTTCGTT: GTTTTTCGTTC
TTAAAACCGCT: TAAAACCGCTA
TTAAAACTGTA: TAAAACTGTAT
TTAAAGGGTTC: TAAAGGGTTCC
TTAAATTGGGA: TAAATTGGGAA
TTAACACGTCC: TAACACGTCCC
TTAACATTTTG: TAACATTTTGC
TTAACTGGAGT: TAACTGGAGTG
TTAAGCGAGGC: TAAGCGAGGCC
TTAAGTCGAAA: TAAGTCGAAAT
TTAATAGAGGG: TAATAGAGGGG
TTAATGGACCC: TAATGGACCCA
TTACAACCTGT: TACAACCTGTC
TTACAGCAACG: TACAGCAACGT
TTACTAAACGT: TACTAAACGTA
TTACTAGCAAT: TACTAGCAATC
TTAGCCGATTA: TAGCCGATTAG
TTAGCTATTGC: TAGCTATTGCA
TTAGCTTGAGG: TAGCTTGAGGC
TTAGGGCATAT: TAGGGCATATC
TTAGGGGTATC: TAGGGGTATCC
TTAGGGTAATT: TAGGGTAATTT
TTAGGTCCAGC: TAGGTCCAGCC
TTAGTCATGGG: TAGTCATGGGT
TTAGTTGGTAC: TAGTTGGTACG
TTATATTTGGA: TATATTTGGAC
TTATCACGCAA: TATCACGCAAT
TTATCTTGACC: TATCTTGACCT
TTATCTTGTGA: TATCTTGTGAG
TTATGACACCT: TATGACACCTA
TTATGTTTTTC: TATGTTTTTCG
TTATTAATGGA: TATTAATGGAC
TTATTGCAGTA: TATTGCAGTAT
TTCACGACGAC: TCACGACGACA
TTCACTACGCG: TCACTACGCGA
TTCACTGATAG: TCACTGATAGT
TTCAGAACGTG: TCAGAACGTGA
TTCAGAAGGTC: TCAGAAGGTCA
TTCAGCAAGCT: TCAGCAAGCTA
TTCAGCTTGCC: TCAGCTTGCCG
TTCAGGCCGCT: TCAGGCCGCTT
TTCATATGCCC: TCATATGCCCC
TTCATGCAGTT: TCATGCAGTTA
TTCATGGATAG: TCATGGATAGC
TTCATGGTTCG: TCATGGTTCGC
TTCATTCGGTC: TCATTCGGTCC
TTCCCCTCTAT: TCCCCTCTATG
TTCCCGACGAC: TCCCGACGACA
TTCCGGCTAGC: TCCGGCTAGCA
TTCCGGCTTCG: TCCGGCTTCGG
TTCCTGATCCG: TCCTGATCCGG
TTCGAAATCAG: TCGAAATCAGA
TTCGATATATG: TCGATATATGG
TTCGCGCAATG: TCGCGCAATGG
TTCGCGTAAAT: TCGCGTAAATC
TTCGCTCACAG: TCGCTCACAGG
TTCGGACCGCG: TCGGACCGCGT
TTCGGGGTCTA: TCGGGGTCTAG
TTCGGGTCACT: TCGGGTCACTG
TTCGGGTCGAA: TCGGGTCGAAT
TTCGGTCCCGA: TCGGTCCCGAT
TTCGTTCCTGA: TCGTTCCTGAT
TTCTCAACCGA: TCTCAACCGAT
TTCTGTAAGCA: TCTGTAAGCAC
TTCTTAAAGGG: TCTTAAAGGGT
TTGAATCATAC: TGAATCATACT
TTGACCTCTCG: TGACCTCTCGT
TTGAGATGATT: TGAGATGATTC
TTGAGCCGGCG: TGAGCCGGCGT
TTGAGGCAGTT: TGAGGCAGTTA
TTGAGTTGAAT: TGAGTTGAATC
TTGATAAGCGT: TGATAAGCGTT
TTGCAACCACA: TGCAACCACAT
TTGCACTTGAG: TGCACTTGAGA
TTGCAGTATCA: TGCAGTATCAG
TTGCATAGAAA: TGCATAGAAAG
TTGCCGGGAAC: TGCCGGGAACT
TTGCCTGGCTG: TGCCTGGCTGG
TTGCTTCAGAA: TGCTTCAGAAG
TTGCTTGGACA: TGCTTGGACAT
TTGGACATAAC: TGGACATAACC
TTGGACGACCC: TGGACGACCCT
TTGGGAAAATC: TGGGAAAATCG
TTGGGCCGACT: TGGGCCGACTA
TTGGTACGTCC: TGGTACGTCCA
TTGGTGGTTCG: TGGTGGTTCGA
TTGTACTATGA: TGTACTATGAT
TTGTCATTCAG: TGTCATTCAGG
TTGTCCTGATA: TGTCCTGATAT
TTGTCCTGCTT: TGTCCTGCTTC
TTGTCGCTGCC: TGTCGCTGCCA
TTGTGAGTCTA: TGTGAGTCTAC
TTGTTATATTT: TGTTATATTTG
TTTAAGTCGAA: TTAAGTCGAAA
TTTACAGCAAC: TTACAGCAACG
TTTATTAATGG: TTATTAATGGA
TTTCACTACGC: TTCACTACGCG
TTTCAGCAAGC: TTCAGCAAGCT
TTTCATGCAGT: TTCATGCAGTT
TTTCATGGTTC: TTCATGGTTCG
TTTCGCGTAAA: TTCGCGTAAAT
TTTCGGGGTCT: TTCGGGGTCTA
TTTCGTTCCTG: TTCGTTCCTGA
TTTCTGTAAGC: TTCTGTAAGCA
TTTGAGCCGGC: TTGAGCCGGCG
TTTGATAAGCG: TTGATAAGCGT
TTTGCAACCAC: TTGCAACCACA
TTTGCCTGGCT: TTGCCTGGCTG
TTTGGACGACC: TTGGACGACCC
TTTGTACTATG: TTGTACTATGA
TTTGTCATTCA: TTGTCATTCAG
TTTGTCCTGAT: TTGTCCTGATA
TTTTCATGCAG: TTTCATGCAGT
TTTTCGCGTAA: TTTCGCGTAAA
TTTTCGTTCCT: TTTCGTTCCTG
TTTTGCCTGGC: TTTGCCTGGCT
TTTTGTCCTGA: TTTGTCCTGAT
TTTTTCGTTCC: TTTTCGTTCCT